Regione,Ricoverati con sintomi,Terapia intensiva,Isolamento domiciliare,Totale attualmente positivi,DIMESSI/GUARITI,DECEDUTI,CASI TOTALI - A,INCREMENTO CASI TOTALI (rispetto al giorno precedente),Casi identificatidal sospettodiagnostico,Casi identificatida attivit√† discreening,CASI TOTALI - B,Totale casi testati,Totale tamponi effettuati,INCREMENTOTAMPONI,REPORT DATE
Lombardia,1521,134,28235,29890,87591,17123,134604,4125,113622,20982,134604,1611623,2575003,36416,2020-10-21
Piemonte,1111,74,12250,13435,30467,4216,48118,1799,26093,22025,48118,529281,895399,13611,2020-10-21
Emilia-Romagna,596,86,10118,10800,27257,4531,42588,671,34999,7589,42588,777142,1417038,17165,2020-10-21
Veneto,439,56,10938,11433,24550,2282,38265,1422,23338,14927,38265,849385,2178114,19627,2020-10-21
Campania,996,85,20020,21101,8838,545,30484,1760,28264,2220,30484,548083,802965,13878,2020-10-21
Lazio,1226,129,16048,17403,9913,1054,28370,1219,11598,16772,28370,984926,1205529,20505,2020-10-21
Toscana,503,76,11660,12239,12006,1221,25466,866,20011,5455,25466,639007,950782,11629,2020-10-21
Liguria,547,31,4043,4621,13614,1656,19891,546,13925,5966,19891,204834,389326,4950,2020-10-21
Sicilia,565,83,7202,7850,5551,389,13790,562,8879,4911,13790,437540,614264,7412,2020-10-21
Puglia,438,42,5511,5991,5690,644,12325,324,3322,9003,12325,355311,502331,5300,2020-10-21
Marche,115,19,2243,2377,6497,997,9871,226,9871,0,9871,169343,289086,2540,2020-10-21
PA Trento,48,2,798,848,5898,420,7166,148,4110,3056,7166,109666,266366,2760,2020-10-21
Friuli Venezia Giulia,76,16,2014,2106,4382,367,6855,219,6306,549,6855,212729,486925,4627,2020-10-21
Abruzzo,212,14,2865,3091,3195,500,6786,252,5397,1389,6786,158874,253175,3123,2020-10-21
Sardegna,236,36,3539,3811,2652,180,6643,167,2714,3929,6643,199392,235250,2223,2020-10-21
Umbria,152,20,2783,2955,2403,95,5453,350,2183,3270,5453,154074,262392,3691,2020-10-21
PA Bolzano,96,7,1977,2080,2926,296,5302,189,5302,0,5302,108212,208717,1884,2020-10-21
Calabria,81,6,1293,1380,1614,105,3099,136,1159,1940,3099,243043,245158,2458,2020-10-21
Valle d'Aosta,42,5,784,831,1155,146,2132,111,1913,219,2132,23483,35990,1555,2020-10-21
Basilicata,48,4,723,775,584,39,1398,85,453,945,1398,90497,91337,1201,2020-10-21
Molise,9,1,415,425,591,26,1042,22,996,46,1042,53291,56882,1293,2020-10-21
Lombardia,1268,123,24913,26304,87072,17103,130479,2023,110712,19767,130479,1588800,2538587,21726,2020-10-20
Piemonte,1037,62,10783,11882,30228,4209,46319,1396,25539,20780,46319,519289,881788,13018,2020-10-20
Emilia-Romagna,531,78,9559,10168,27226,4523,41917,507,34633,7284,41917,769327,1399873,16549,2020-10-20
Veneto,459,51,9746,10256,24319,2268,36843,490,22987,13856,36843,841548,2158487,8126,2020-10-20
Campania,946,91,18421,19458,8732,534,28724,1312,26534,2190,28724,538297,789087,10205,2020-10-20
Lazio,1196,123,15014,16333,9780,1038,27151,1224,11206,15945,27151,969373,1185024,21117,2020-10-20
Toscana,475,72,10999,11546,11846,1208,24600,812,19332,5268,24600,631648,939153,11351,2020-10-20
Liguria,505,32,3947,4484,13214,1647,19345,907,13628,5717,19345,202738,384376,6062,2020-10-20
Sicilia,542,77,6878,7497,5353,378,13228,574,8485,4743,13228,434040,606852,8131,2020-10-20
Puglia,432,39,5259,5730,5629,642,12001,295,3240,8761,12001,350691,497031,5827,2020-10-20
Marche,99,19,2064,2182,6467,996,9645,89,9645,0,9645,167857,286546,1882,2020-10-20
PA Trento,45,1,718,764,5836,418,7018,94,4039,2979,7018,108619,263606,854,2020-10-20
Friuli Venezia Giulia,65,14,1853,1932,4338,366,6636,131,6115,521,6636,211397,482298,3915,2020-10-20
Abruzzo,210,15,2620,2845,3194,495,6534,184,5319,1215,6534,156991,250052,3115,2020-10-20
Sardegna,226,34,3426,3686,2613,177,6476,221,2674,3802,6476,197486,233027,2016,2020-10-20
PA Bolzano,96,7,1791,1894,2924,295,5113,209,5113,0,5113,107299,206833,1819,2020-10-20
Umbria,150,20,2505,2675,2335,93,5103,194,2133,2970,5103,152168,258701,4371,2020-10-20
Calabria,73,6,1173,1252,1607,104,2963,94,1159,1804,2963,240594,242700,2477,2020-10-20
Valle d'Aosta,36,5,684,725,1150,146,2021,75,1813,208,2021,23263,34435,583,2020-10-20
Basilicata,51,1,661,713,561,39,1313,17,453,860,1313,89296,90136,1115,2020-10-20
Molise,12,0,401,413,581,26,1020,26,975,45,1020,52527,55589,478,2020-10-20
Lombardia,1136,113,23385,24634,86738,17084,128456,1687,109408,19048,128456,1575120,2516861,14577,2020-10-19
Piemonte,883,61,9663,10607,30113,4203,44923,933,26243,18680,44923,511428,868770,9564,2020-10-19
Emilia-Romagna,481,70,9119,9670,27222,4518,41410,552,34342,7068,41410,763923,1383324,8026,2020-10-19
Veneto,396,44,9405,9845,24253,2255,36353,502,22902,13451,36353,838391,2150361,4426,2020-10-19
Campania,884,85,17345,18314,8576,522,27412,1593,25252,2160,27412,529648,778882,12695,2020-10-19
Lazio,1130,111,13950,15191,9703,1033,25927,939,11105,14822,25927,954419,1163907,17573,2020-10-19
Toscana,449,62,10340,10851,11731,1206,23788,986,18734,5054,23788,624289,927802,10557,2020-10-19
Liguria,436,34,3441,3911,12886,1641,18438,323,12884,5554,18438,199539,378314,1871,2020-10-19
Sicilia,521,72,6426,7019,5267,368,12654,362,8095,4559,12654,428508,598721,3252,2020-10-19
Puglia,397,38,5028,5463,5604,639,11706,321,3144,8562,11706,346220,491204,2446,2020-10-19
Marche,97,16,2005,2118,6443,995,9556,98,9556,0,9556,166944,284664,1217,2020-10-19
PA Trento,44,0,819,863,5643,418,6924,79,4007,2917,6924,108329,262752,1518,2020-10-19
Friuli Venezia Giulia,62,13,2093,2168,3973,364,6505,90,6017,488,6505,210178,478383,1281,2020-10-19
Abruzzo,197,13,2459,2669,3190,494,6353,159,5282,1071,6353,155193,246937,2176,2020-10-19
Sardegna,210,33,3259,3502,2579,174,6255,159,2600,3655,6255,195681,231011,2306,2020-10-19
Umbria,131,15,2423,2569,2247,93,4909,167,2099,2810,4909,150026,254330,1028,2020-10-19
PA Bolzano,67,7,1616,1690,2920,294,4904,85,4904,0,4904,106284,205014,1279,2020-10-19
Calabria,66,5,1099,1170,1595,104,2869,108,1159,1710,2869,238117,240223,1476,2020-10-19
Valle d'Aosta,26,4,628,658,1142,146,1946,135,1746,200,1946,23091,33852,453,2020-10-19
Basilicata,51,1,646,698,559,39,1296,22,453,843,1296,88191,89021,397,2020-10-19
Molise,12,0,381,393,575,26,994,38,949,45,994,52049,55111,744,2020-10-19
Lombardia,1065,110,22119,23294,86397,17078,126769,2975,108092,18677,126769,1565233,2502284,30981,2020-10-18
Piemonte,780,55,8998,9833,29959,4198,43990,1123,25943,18047,43990,505300,859206,9721,2020-10-18
Emilia-Romagna,439,67,8657,9163,27181,4515,40859,526,34047,6812,40859,760075,1375298,9189,2020-10-18
Veneto,378,44,9003,9425,24170,2256,35851,800,22849,13002,35851,836440,2145935,10285,2020-10-18
Campania,849,78,15938,16865,8453,501,25819,1376,23716,2103,25819,519783,766187,14256,2020-10-18
Lazio,1085,99,13196,14380,9584,1024,24988,1198,10930,14058,24988,941774,1146334,23010,2020-10-18
Toscana,385,55,9546,9986,11622,1194,22802,906,17869,4933,22802,617111,917245,13380,2020-10-18
Liguria,402,39,3318,3759,12720,1636,18115,370,12740,5375,18115,198617,376443,3328,2020-10-18
Sicilia,493,70,6227,6790,5137,365,12292,548,7835,4457,12292,426503,595469,6390,2020-10-18
Puglia,377,36,4820,5233,5517,635,11385,301,3113,8272,11385,344122,488758,4633,2020-10-18
Marche,88,13,1944,2045,6418,995,9458,204,9458,0,9458,166250,283447,2542,2020-10-18
PA Trento,38,0,763,801,5627,417,6845,48,3983,2862,6845,108040,261234,830,2020-10-18
Friuli Venezia Giulia,56,14,2011,2081,3973,361,6415,155,5927,488,6415,209531,477102,2295,2020-10-18
Abruzzo,170,13,2330,2513,3187,494,6194,221,5175,1019,6194,153850,244761,3715,2020-10-18
Sardegna,208,29,3159,3396,2526,174,6096,230,2557,3539,6096,193627,228705,1911,2020-10-18
PA Bolzano,67,7,1533,1607,2919,293,4819,171,4819,0,4819,105500,203735,1979,2020-10-18
Umbria,115,14,2302,2431,2219,92,4742,327,2062,2680,4742,149410,253302,3412,2020-10-18
Calabria,61,5,1006,1072,1585,104,2761,78,1159,1602,2761,236641,238747,2359,2020-10-18
Valle d'Aosta,20,2,506,528,1137,146,1811,73,1631,180,1811,22840,33399,360,2020-10-18
Basilicata,43,0,637,680,555,39,1274,48,444,830,1274,87784,88624,950,2020-10-18
Molise,12,0,343,355,575,26,956,27,911,45,956,51313,54367,1015,2020-10-18
Lombardia,943,96,20586,21625,85112,17057,123794,2664,106066,17728,123794,1544959,2471303,29053,2020-10-17
Piemonte,701,51,8128,8880,29791,4196,42867,972,25648,17219,42867,498420,849485,11066,2020-10-17
Emilia-Romagna,427,65,8157,8649,27175,4509,40333,641,33741,6592,40333,754101,1366109,13313,2020-10-17
Veneto,328,43,8369,8740,24064,2247,35051,774,22758,12293,35051,832701,2135650,14156,2020-10-17
Campania,817,75,14798,15690,8254,499,24443,1410,22363,2080,24443,509918,751931,14704,2020-10-17
Lazio,1043,98,12096,13237,9535,1018,23790,994,10392,13398,23790,924313,1123324,27748,2020-10-17
Toscana,344,50,8853,9247,11460,1189,21896,879,17020,4876,21896,608130,903865,13548,2020-10-17
Liguria,364,38,3156,3558,12554,1633,17745,464,12399,5346,17745,197088,373115,5173,2020-10-17
Sicilia,479,61,5741,6281,5101,362,11744,475,7493,4251,11744,422068,589079,5739,2020-10-17
Puglia,368,33,4579,4980,5472,632,11084,350,3035,8049,11084,342024,484125,5382,2020-10-17
Marche,77,10,1775,1862,6400,992,9254,121,9254,0,9254,164588,280905,2194,2020-10-17
PA Trento,27,0,744,771,5609,417,6797,82,3956,2841,6797,107750,260404,2593,2020-10-17
Friuli Venezia Giulia,49,13,1877,1939,3962,359,6260,167,5782,478,6260,208471,474807,4340,2020-10-17
Abruzzo,169,13,2112,2294,3186,493,5973,148,4950,1023,5973,151830,241046,3103,2020-10-17
Sardegna,192,30,2966,3188,2506,172,5866,130,2440,3426,5866,191734,226794,2995,2020-10-17
PA Bolzano,66,6,1372,1444,2911,293,4648,155,4648,0,4648,104499,201756,1714,2020-10-17
Umbria,99,16,2015,2130,2193,92,4415,205,1985,2430,4415,147587,249890,3525,2020-10-17
Calabria,58,5,931,994,1585,104,2683,94,1159,1524,2683,234284,236388,2995,2020-10-17
Valle d'Aosta,17,2,439,458,1134,146,1738,78,1569,169,1738,22585,33039,421,2020-10-17
Basilicata,40,0,598,638,550,38,1226,57,441,785,1226,86834,87674,1123,2020-10-17
Molise,9,0,321,330,573,26,929,65,884,45,929,50306,53352,952,2020-10-17
Lombardia,834,71,18223,19128,84958,17044,121130,2419,104276,16854,121130,1527182,2442250,30587,2020-10-16
Piemonte,658,43,7357,8058,29643,4194,41895,821,25387,16508,41895,493847,838419,9707,2020-10-16
Emilia-Romagna,404,61,7568,8033,27155,4504,39692,544,33382,6310,39692,748337,1352796,13563,2020-10-16
Veneto,299,40,7799,8138,23895,2244,34277,704,22660,11617,34277,828067,2121494,7368,2020-10-16
Campania,786,67,13501,14354,8180,499,23033,1261,20983,2050,23033,498492,737227,14222,2020-10-16
Lazio,1004,98,11215,12317,9473,1006,22796,795,10030,12766,22796,901184,1095576,19438,2020-10-16
Toscana,308,51,8156,8515,11315,1187,21017,755,16194,4823,21017,598910,890317,11500,2020-10-16
Liguria,347,32,2862,3241,12408,1632,17281,585,11989,5292,17281,194933,367942,4980,2020-10-16
Sicilia,471,58,5405,5934,4975,360,11269,578,7238,4031,11269,416980,583340,7709,2020-10-16
Puglia,326,26,4321,4673,5431,630,10734,313,3007,7727,10734,338385,478743,5582,2020-10-16
Marche,73,10,1671,1754,6387,992,9133,115,9133,0,9133,163367,278711,2198,2020-10-16
PA Trento,20,0,705,725,5574,416,6715,111,3931,2784,6715,107156,257811,2376,2020-10-16
Friuli Venezia Giulia,45,12,1742,1799,3935,359,6093,165,5622,471,6093,206998,470467,5327,2020-10-16
Abruzzo,167,11,1972,2150,3184,491,5825,178,4828,997,5825,150236,237943,3668,2020-10-16
Sardegna,187,29,2879,3095,2470,171,5736,133,2403,3333,5736,189006,223799,2450,2020-10-16
PA Bolzano,66,6,1231,1303,2897,293,4493,128,4493,0,4493,103548,200042,2152,2020-10-16
Umbria,75,15,1871,1961,2158,91,4210,198,1940,2270,4210,145535,246365,2961,2020-10-16
Calabria,51,4,849,904,1581,104,2589,102,1159,1430,2589,231287,233393,2758,2020-10-16
Valle d'Aosta,13,4,365,382,1132,146,1660,27,1499,161,1660,22334,32618,177,2020-10-16
Basilicata,36,0,547,583,548,38,1169,57,437,732,1169,85721,86551,1116,2020-10-16
Molise,8,0,257,265,573,26,864,21,819,45,864,49359,52400,538,2020-10-16
Lombardia,726,72,16252,17050,84624,17037,118711,2067,102862,15849,118711,1508334,2411663,32507,2020-10-15
Piemonte,595,40,6673,7308,29576,4190,41074,1033,25197,15877,41074,489887,828712,14142,2020-10-15
Emilia-Romagna,392,49,7080,7521,27124,4503,39148,453,33090,6058,39148,742503,1339233,12631,2020-10-15
Veneto,279,40,7289,7608,23728,2237,33573,600,22546,11027,33573,825788,2114126,19024,2020-10-15
Lazio,969,90,10546,11605,9395,1001,22001,594,9823,12178,22001,884989,1076138,15930,2020-10-15
Campania,762,66,12416,13244,8032,496,21772,1127,19740,2032,21772,487147,723005,13780,2020-10-15
Toscana,276,46,7584,7906,11171,1185,20262,581,15463,4799,20262,591385,878817,11146,2020-10-15
Liguria,316,26,2771,3113,11957,1626,16696,432,11472,5224,16696,192467,362962,5149,2020-10-15
Sicilia,468,52,4967,5487,4854,350,10691,399,6856,3835,10691,411784,575631,7444,2020-10-15
Puglia,319,26,4064,4409,5387,625,10421,257,2947,7474,10421,334382,473161,5346,2020-10-15
Marche,61,9,1594,1664,6362,992,9018,140,9018,0,9018,162176,276513,2674,2020-10-15
PA Trento,20,0,648,668,5521,415,6604,62,3905,2699,6604,106544,255435,1655,2020-10-15
Friuli Venezia Giulia,32,11,1604,1647,3923,358,5928,136,5472,456,5928,205301,465140,5027,2020-10-15
Abruzzo,159,10,1824,1993,3164,491,5648,203,4688,960,5648,148088,234275,3222,2020-10-15
Sardegna,180,28,2816,3024,2410,169,5603,186,2357,3246,5603,186956,221349,2688,2020-10-15
PA Bolzano,60,3,1130,1193,2879,293,4365,98,4365,0,4365,102467,197890,1743,2020-10-15
Umbria,74,12,1731,1817,2104,91,4012,263,1903,2109,4012,144075,243404,3690,2020-10-15
Calabria,51,3,805,859,1524,104,2487,39,1159,1328,2487,228529,230635,1957,2020-10-15
Valle d'Aosta,14,3,343,360,1127,146,1633,67,1472,161,1633,22227,32441,420,2020-10-15
Basilicata,36,0,503,539,536,37,1112,37,436,676,1112,84605,85435,986,2020-10-15
Molise,7,0,244,251,566,26,843,30,798,45,843,48828,51862,1771,2020-10-15
Lombardia,645,64,14509,15218,84415,17011,116644,1844,101508,15136,116644,1488016,2379156,29048,2020-10-14
Piemonte,562,33,5792,6387,29467,4187,40041,499,24827,15214,40041,482280,814570,5967,2020-10-14
Emilia-Romagna,383,35,6730,7148,27045,4502,38695,339,32848,5847,38695,736069,1326602,15607,2020-10-14
Veneto,271,35,6876,7182,23565,2226,32973,657,22436,10537,32973,818552,2095102,21095,2020-10-14
Lazio,937,85,10041,11063,9350,994,21407,543,9644,11763,21407,872710,1060208,15484,2020-10-14
Campania,735,61,11647,12443,7715,487,20645,818,18656,1989,20645,476051,709225,11396,2020-10-14
Toscana,229,46,7152,7427,11071,1183,19681,575,14954,4727,19681,583506,867671,11033,2020-10-14
Liguria,286,29,2760,3075,11566,1623,16264,362,11297,4967,16264,190129,357813,3981,2020-10-14
Sicilia,447,49,4691,5187,4762,343,10292,366,6582,3710,10292,407145,568187,7021,2020-10-14
Puglia,311,23,3895,4229,5317,618,10164,315,2877,7287,10164,330789,467815,5844,2020-10-14
Marche,64,8,1465,1537,6349,992,8878,166,8878,0,8878,160725,273839,3082,2020-10-14
PA Trento,20,0,638,658,5471,413,6542,29,3889,2653,6542,106152,253780,2567,2020-10-14
Friuli Venezia Giulia,28,11,1515,1554,3882,356,5792,182,5344,448,5792,203239,460113,6030,2020-10-14
Abruzzo,154,15,1632,1801,3156,489,5446,126,4555,891,5446,146193,231053,2529,2020-10-14
Sardegna,172,26,2728,2926,2323,168,5417,122,2275,3142,5417,184574,218661,2158,2020-10-14
PA Bolzano,54,3,1061,1118,2856,293,4267,124,4267,0,4267,101569,196147,1573,2020-10-14
Umbria,71,12,1540,1623,2035,91,3749,141,1863,1886,3749,142109,239714,3427,2020-10-14
Calabria,44,1,801,846,1498,104,2448,60,1159,1289,2448,226572,228678,2435,2020-10-14
Valle d'Aosta,13,3,279,295,1125,146,1566,37,1415,151,1566,21997,32021,258,2020-10-14
Basilicata,35,0,469,504,534,37,1075,9,435,640,1075,83619,84449,968,2020-10-14
Molise,9,0,215,224,563,26,813,18,770,43,813,47924,50091,693,2020-10-14
Lombardia,546,62,13648,14256,83550,16994,114800,1080,100262,14538,114800,1469625,2350108,17186,2020-10-13
Piemonte,483,30,5452,5965,29394,4183,39542,585,24702,14840,39542,480303,808603,9182,2020-10-13
Emilia-Romagna,323,31,6522,6876,26982,4498,38356,341,32669,5687,38356,728221,1310995,13344,2020-10-13
Veneto,272,33,6350,6655,23435,2226,32316,485,22334,9982,32316,810366,2074007,4052,2020-10-13
Lazio,896,83,9658,10637,9238,989,20864,579,9457,11407,20864,861669,1044724,15408,2020-10-13
Campania,694,62,11022,11778,7564,485,19827,635,17861,1966,19827,467964,697829,7720,2020-10-13
Toscana,218,44,6655,6917,11008,1181,19106,480,14546,4560,19106,576101,856638,8172,2020-10-13
Liguria,272,27,2624,2923,11357,1622,15902,447,11088,4814,15902,188093,353832,4766,2020-10-13
Sicilia,426,44,4407,4877,4708,341,9926,334,6366,3560,9926,402751,561166,8340,2020-10-13
Puglia,310,23,3665,3998,5235,616,9849,180,2800,7049,9849,327324,461971,5588,2020-10-13
Marche,60,6,1329,1395,6325,992,8712,82,8712,0,8712,158948,270757,1525,2020-10-13
PA Trento,20,0,665,685,5417,411,6513,28,3884,2629,6513,105581,251213,801,2020-10-13
Friuli Venezia Giulia,27,10,1367,1404,3850,356,5610,38,5165,445,5610,200782,454083,2747,2020-10-13
Abruzzo,146,15,1518,1679,3153,488,5320,146,4437,883,5320,144769,228524,2877,2020-10-13
Sardegna,164,26,2710,2900,2227,168,5295,157,2257,3038,5295,182625,216503,2466,2020-10-13
PA Bolzano,54,3,937,994,2856,293,4143,34,4143,0,4143,100855,194574,683,2020-10-13
Umbria,68,11,1412,1491,2027,90,3608,136,1855,1753,3608,140125,236287,3035,2020-10-13
Calabria,42,1,755,798,1486,104,2388,44,1159,1229,2388,224137,226243,2383,2020-10-13
Valle d'Aosta,11,3,244,258,1125,146,1529,33,1383,146,1529,21861,31763,271,2020-10-13
Basilicata,34,0,463,497,532,37,1066,8,434,632,1066,82651,83481,1201,2020-10-13
Molise,10,0,200,210,559,26,795,49,753,42,795,47568,49398,797,2020-10-13
Lombardia,463,50,12866,13379,83353,16988,113720,696,99501,14219,113720,1458192,2332922,13934,2020-10-12
Piemonte,457,22,4984,5463,29314,4180,38957,454,24579,14378,38957,476939,799421,6386,2020-10-12
Emilia-Romagna,284,25,6364,6673,26849,4496,38018,337,32487,5531,38018,723741,1297651,6660,2020-10-12
Veneto,244,29,6016,6289,23323,2219,31831,328,22250,9581,31831,808554,2069955,6348,2020-10-12
Lazio,927,78,9117,10122,9179,984,20285,395,9280,11005,20285,849390,1029316,13830,2020-10-12
Campania,685,64,10477,11226,7487,479,19192,662,17258,1934,19192,460813,690109,7405,2020-10-12
Toscana,205,40,6259,6504,10942,1180,18626,466,14189,4437,18626,570706,848466,8958,2020-10-12
Liguria,261,24,2456,2741,11093,1621,15455,186,10734,4721,15455,185406,349066,1570,2020-10-12
Puglia,307,19,3587,3913,5142,614,9669,157,2762,6907,9669,323084,456383,2433,2020-10-12
Sicilia,404,42,4236,4682,4571,339,9592,298,6133,3459,9592,397546,552826,3892,2020-10-12
Marche,50,5,1274,1329,6309,992,8630,37,8630,0,8630,158054,269232,837,2020-10-12
PA Trento,19,0,661,680,5396,409,6485,2,3869,2616,6485,105284,250412,125,2020-10-12
Friuli Venezia Giulia,22,5,1345,1372,3844,356,5572,59,5130,442,5572,199799,451336,1696,2020-10-12
Abruzzo,137,11,1384,1532,3154,488,5174,117,4336,838,5174,142974,225647,2227,2020-10-12
Sardegna,157,23,2679,2859,2113,166,5138,129,2220,2918,5138,180487,214037,1578,2020-10-12
PA Bolzano,42,2,929,973,2843,293,4109,45,4109,0,4109,100427,193891,1047,2020-10-12
Umbria,61,9,1300,1370,2012,90,3472,148,1844,1628,3472,138736,233252,4509,2020-10-12
Calabria,42,1,730,773,1467,104,2344,53,1159,1185,2344,221754,223860,1228,2020-10-12
Valle d'Aosta,9,3,213,225,1125,146,1496,32,1352,144,1496,21680,31492,219,2020-10-12
Basilicata,36,0,459,495,528,35,1058,11,434,624,1058,81450,82280,130,2020-10-12
Molise,9,0,155,164,556,26,746,7,704,42,746,47043,48601,430,2020-10-12
Lombardia,433,48,12368,12849,83190,16985,113024,1032,99044,13980,113024,1448672,2318988,15590,2020-10-11
Piemonte,378,24,4654,5056,29270,4177,38503,409,24480,14023,38503,472398,793035,6480,2020-10-11
Emilia-Romagna,254,23,6072,6349,26837,4495,37681,384,32282,5399,37681,719690,1290991,8660,2020-10-11
Veneto,238,24,5826,6088,23197,2218,31503,438,22196,9307,31503,806051,2063607,11140,2020-10-11
Lazio,911,69,8862,9842,9072,976,19890,371,9236,10654,19890,836669,1015486,12733,2020-10-11
Campania,664,61,9969,10694,7357,479,18530,633,16669,1861,18530,454679,682704,9232,2020-10-11
Toscana,186,31,5925,6142,10844,1174,18160,517,13854,4306,18160,564468,839508,11394,2020-10-11
Liguria,238,26,2334,2598,11052,1619,15269,386,10599,4670,15269,184673,347496,3334,2020-10-11
Puglia,301,21,3485,3807,5097,608,9512,212,2715,6797,9512,321156,453950,3887,2020-10-11
Sicilia,388,38,3975,4401,4557,336,9294,297,5953,3341,9294,395172,548934,4509,2020-10-11
Marche,44,6,1253,1303,6298,992,8593,108,8593,0,8593,157585,268395,2385,2020-10-11
PA Trento,19,0,662,681,5394,408,6483,39,3869,2614,6483,105220,250287,1847,2020-10-11
Friuli Venezia Giulia,22,5,1296,1323,3834,356,5513,97,5071,442,5513,198763,449640,1694,2020-10-11
Abruzzo,116,8,1293,1417,3153,487,5057,77,4245,812,5057,141605,223420,2278,2020-10-11
Sardegna,140,22,2610,2772,2072,165,5009,143,2196,2813,5009,179167,212459,1752,2020-10-11
PA Bolzano,35,1,904,940,2831,293,4064,84,4064,0,4064,99917,192844,1599,2020-10-11
Umbria,58,9,1169,1236,2000,88,3324,135,1834,1490,3324,136523,228743,2779,2020-10-11
Calabria,41,1,688,730,1458,103,2291,35,1159,1132,2291,220526,222632,1696,2020-10-11
Valle d'Aosta,8,3,186,197,1121,146,1464,18,1320,144,1464,21530,31273,240,2020-10-11
Basilicata,36,0,449,485,527,35,1047,13,434,613,1047,81320,82150,957,2020-10-11
Molise,9,0,156,165,548,26,739,28,697,42,739,46626,48171,472,2020-10-11
Lombardia,408,44,11570,12022,82988,16982,111992,1140,98339,13653,111992,1438722,2303398,22910,2020-10-10
Piemonte,354,22,4365,4741,29179,4174,38094,499,24363,13731,38094,467397,786555,8588,2020-10-10
Emilia-Romagna,241,16,5719,5976,26827,4494,37297,383,32069,5228,37297,715054,1282331,13779,2020-10-10
Veneto,231,20,5581,5832,23017,2216,31065,561,22136,8929,31065,801647,2052467,14996,2020-10-10
Lazio,884,57,8564,9505,9042,972,19519,384,9070,10449,19519,826222,1002753,14358,2020-10-10
Campania,635,63,9493,10191,7229,477,17897,664,16060,1837,17897,446216,673472,9031,2020-10-10
Toscana,160,30,5450,5640,10830,1173,17643,548,13504,4139,17643,556336,828114,11237,2020-10-10
Liguria,222,26,2198,2446,10820,1617,14883,213,10284,4599,14883,183026,344162,4033,2020-10-10
Puglia,300,22,3389,3711,4982,607,9300,184,2655,6645,9300,319289,450063,5189,2020-10-10
Sicilia,387,35,3721,4143,4519,335,8997,285,5782,3215,8997,392395,544425,7741,2020-10-10
Marche,41,3,1159,1203,6290,992,8485,86,8485,0,8485,156147,266010,2398,2020-10-10
PA Trento,19,0,668,687,5349,408,6444,50,3861,2583,6444,104720,248440,2331,2020-10-10
Friuli Venezia Giulia,23,6,1215,1244,3817,355,5416,126,4976,440,5416,197963,447946,4269,2020-10-10
Abruzzo,110,7,1224,1341,3152,487,4980,94,4194,786,4980,140150,221142,2388,2020-10-10
Sardegna,140,25,2506,2671,2034,161,4866,124,2172,2694,4866,177776,210707,1619,2020-10-10
PA Bolzano,35,2,836,873,2815,292,3980,92,3980,0,3980,99125,191245,1880,2020-10-10
Umbria,56,8,1046,1110,1991,88,3189,132,1824,1365,3189,134818,225964,2173,2020-10-10
Calabria,41,1,654,696,1457,103,2256,68,1159,1097,2256,218830,220936,2545,2020-10-10
Valle d'Aosta,6,3,171,180,1120,146,1446,44,1304,142,1446,21356,31033,229,2020-10-10
Basilicata,36,0,439,475,524,35,1034,37,434,600,1034,80358,81193,861,2020-10-10
Molise,7,0,135,142,543,26,711,10,669,42,711,46155,47699,529,2020-10-10
Lombardia,371,44,10713,11128,82744,16980,110852,983,97697,13155,110852,1424471,2280488,25623,2020-10-09
Piemonte,345,22,3943,4310,29113,4172,37595,401,24243,13352,37595,462323,777967,6811,2020-10-09
Emilia-Romagna,226,14,5369,5609,26812,4493,36914,276,31848,5066,36914,709568,1268552,10747,2020-10-09
Veneto,208,21,5245,5474,22821,2209,30504,595,21936,8568,30504,796159,2037471,14325,2020-10-09
Lazio,853,57,8276,9186,8983,966,19135,387,8987,10148,19135,815474,988395,14439,2020-10-09
Campania,576,63,8958,9597,7161,475,17233,769,15420,1813,17233,437971,664441,9549,2020-10-09
Toscana,140,30,4951,5121,10801,1173,17095,483,13074,4021,17095,548458,816877,10781,2020-10-09
Liguria,199,26,2050,2275,10780,1615,14670,196,10165,4505,14670,181069,340129,3457,2020-10-09
Puglia,300,23,3227,3550,4960,606,9116,249,2603,6513,9116,315837,444874,4596,2020-10-09
Sicilia,376,35,3490,3901,4478,333,8712,233,5583,3129,8712,387714,536684,7151,2020-10-09
Marche,37,3,1105,1145,6262,992,8399,49,8399,0,8399,154836,263612,2295,2020-10-09
PA Trento,20,0,661,681,5307,406,6394,39,3843,2551,6394,104126,246109,2001,2020-10-09
Friuli Venezia Giulia,23,6,1112,1141,3794,355,5290,146,4853,437,5290,195965,443677,4307,2020-10-09
Abruzzo,100,7,1142,1249,3150,487,4886,103,4131,755,4886,138835,218754,2787,2020-10-09
Sardegna,133,23,2413,2569,2012,161,4742,134,2144,2598,4742,176462,209088,2555,2020-10-09
PA Bolzano,35,2,760,797,2799,292,3888,85,3888,0,3888,98176,189365,1530,2020-10-09
Umbria,55,8,937,1000,1970,87,3057,151,1810,1247,3057,133522,223791,2645,2020-10-09
Calabria,42,1,595,638,1447,103,2188,42,1159,1029,2188,216285,218391,2157,2020-10-09
Valle d'Aosta,4,2,133,139,1117,146,1402,18,1262,140,1402,21200,30804,160,2020-10-09
Basilicata,35,0,413,448,514,35,997,22,433,564,997,79502,80332,926,2020-10-09
Molise,8,0,144,152,524,25,701,11,659,42,701,45640,47170,629,2020-10-09
Lombardia,361,41,10004,10406,82484,16979,109869,683,97091,12778,109869,1408098,2254865,22069,2020-10-08
Piemonte,311,16,3652,3979,29043,4172,37194,336,24168,13026,37194,459191,771156,7468,2020-10-08
Emilia-Romagna,232,13,5179,5424,26722,4492,36638,184,31698,4940,36638,704510,1257805,11695,2020-10-08
Veneto,213,19,4851,5083,22620,2206,29909,491,21837,8072,29909,790836,2023146,16958,2020-10-08
Lazio,821,55,7976,8852,8936,960,18748,359,8845,9903,18748,805125,973956,13333,2020-10-08
Toscana,132,27,4590,4749,10693,1170,16612,339,12785,3827,16612,541159,806096,9050,2020-10-08
Campania,548,55,8347,8950,7044,470,16464,757,14672,1792,16464,430106,654892,9925,2020-10-08
Liguria,195,28,1932,2155,10705,1614,14474,152,10066,4408,14474,179543,336672,3857,2020-10-08
Puglia,278,23,3033,3334,4929,604,8867,248,2555,6312,8867,312343,440278,4754,2020-10-08
Sicilia,376,33,3287,3696,4454,329,8479,259,5441,3038,8479,383416,529533,7374,2020-10-08
Marche,34,5,1068,1107,6251,992,8350,66,8350,0,8350,153648,261317,2062,2020-10-08
PA Trento,18,0,672,690,5259,406,6355,59,3820,2535,6355,103685,244108,2508,2020-10-08
Friuli Venezia Giulia,23,6,991,1020,3769,355,5144,110,4732,412,5144,194340,439370,4953,2020-10-08
Abruzzo,90,7,1055,1152,3145,486,4783,68,4061,722,4783,137364,215967,2332,2020-10-08
Sardegna,129,19,2322,2470,1977,161,4608,127,2126,2482,4608,174362,206533,2103,2020-10-08
PA Bolzano,30,1,695,726,2785,292,3803,69,3803,0,3803,97393,187835,1897,2020-10-08
Umbria,50,8,805,863,1956,87,2906,84,1770,1136,2906,131965,221146,2380,2020-10-08
Calabria,39,1,563,603,1441,102,2146,21,1159,987,2146,214128,216234,1905,2020-10-08
Valle d'Aosta,4,1,117,122,1116,146,1384,18,1244,140,1384,21086,30644,249,2020-10-08
Basilicata,35,0,394,429,511,35,975,22,433,542,975,78439,79406,737,2020-10-08
Molise,6,0,136,142,523,25,690,6,648,42,690,45014,46541,489,2020-10-08
Lombardia,339,40,9498,9877,82331,16978,109186,520,96683,12503,109186,1395667,2232796,21569,2020-10-07
Piemonte,297,15,3412,3724,28962,4172,36858,287,24075,12783,36858,456021,763688,7523,2020-10-07
Emilia-Romagna,223,14,5058,5295,26668,4491,36454,193,31585,4869,36454,698835,1246110,14881,2020-10-07
Veneto,214,16,4524,4754,22464,2200,29418,375,21700,7718,29418,784296,2006188,15164,2020-10-07
Lazio,808,48,7724,8580,8855,954,18389,357,8713,9676,18389,795451,960623,11908,2020-10-07
Toscana,123,28,4279,4430,10673,1170,16273,300,12593,3680,16273,535058,797046,10014,2020-10-07
Campania,520,52,7771,8343,6895,469,15707,544,13925,1782,15707,422215,644967,7504,2020-10-07
Liguria,196,24,1812,2032,10676,1614,14322,176,10046,4276,14322,177511,332815,3726,2020-10-07
Puglia,251,23,2859,3133,4883,603,8619,196,2502,6117,8619,309260,435524,4822,2020-10-07
Marche,31,5,1016,1052,6240,992,8284,84,8284,0,8284,152490,259255,2517,2020-10-07
Sicilia,375,30,3144,3549,4345,326,8220,213,5299,2921,8220,378610,522159,6579,2020-10-07
PA Trento,18,0,631,649,5241,406,6296,32,3807,2489,6296,102992,241600,2001,2020-10-07
Friuli Venezia Giulia,26,6,913,945,3734,355,5034,72,4632,402,5034,192089,434417,5174,2020-10-07
Abruzzo,88,6,1004,1098,3132,485,4715,61,4002,713,4715,136225,213635,2507,2020-10-07
Sardegna,128,19,2243,2390,1931,160,4481,101,2101,2380,4481,172673,204430,2056,2020-10-07
PA Bolzano,21,1,645,667,2775,292,3734,55,3734,0,3734,96289,185938,1642,2020-10-07
Umbria,44,8,756,808,1928,86,2822,65,1742,1080,2822,135552,218766,2278,2020-10-07
Calabria,37,1,553,591,1432,102,2125,16,1159,966,2125,212223,214329,2001,2020-10-07
Valle d'Aosta,4,1,102,107,1113,146,1366,15,1227,139,1366,20931,30395,264,2020-10-07
Basilicata,35,0,379,414,504,35,953,15,433,520,953,77839,78669,760,2020-10-07
Molise,4,0,134,138,521,25,684,1,642,42,684,44539,46052,424,2020-10-07
Lombardia,320,40,9149,9509,82184,16973,108666,350,96365,12301,108666,1380719,2211227,16020,2020-10-06
Piemonte,293,15,3274,3582,28819,4170,36571,259,23999,12572,36571,452847,756165,8104,2020-10-06
Emilia-Romagna,212,13,4929,5154,26617,4490,36261,172,31487,4774,36261,691551,1231229,11386,2020-10-06
Veneto,208,15,4303,4526,22319,2198,29043,189,21623,7420,29043,777300,1991024,10093,2020-10-06
Lazio,774,44,7472,8290,8794,948,18032,275,8611,9421,18032,786768,948715,10855,2020-10-06
Toscana,117,28,4054,4199,10606,1168,15973,209,12422,3551,15973,528501,787032,6965,2020-10-06
Campania,488,47,7442,7977,6718,468,15163,395,13406,1757,15163,416074,637463,5064,2020-10-06
Liguria,178,23,1724,1925,10609,1612,14146,170,9972,4174,14146,175730,329089,3325,2020-10-06
Puglia,244,21,2726,2991,4829,603,8423,106,2470,5953,8423,306067,430702,4416,2020-10-06
Marche,29,6,947,982,6226,992,8200,35,8200,0,8200,150966,256738,1562,2020-10-06
Sicilia,368,28,3052,3448,4237,322,8007,198,5174,2833,8007,374604,515580,6754,2020-10-06
PA Trento,22,0,641,663,5195,406,6264,40,3801,2463,6264,102600,239599,1047,2020-10-06
Friuli Venezia Giulia,24,5,879,908,3699,355,4962,51,4564,398,4962,190029,429243,3048,2020-10-06
Abruzzo,81,6,971,1058,3113,484,4655,48,3964,691,4655,134677,211128,1548,2020-10-06
Sardegna,125,19,2181,2325,1898,157,4380,63,2079,2301,4380,170991,202374,2319,2020-10-06
PA Bolzano,21,0,609,630,2757,292,3679,17,3679,0,3679,95487,184296,1002,2020-10-06
Umbria,45,5,698,748,1923,86,2757,62,1727,1030,2757,129274,216488,2622,2020-10-06
Calabria,38,1,546,585,1422,102,2109,23,1159,950,2109,210222,212328,1882,2020-10-06
Valle d'Aosta,5,1,87,93,1112,146,1351,5,1214,137,1351,20774,30131,151,2020-10-06
Basilicata,30,2,371,403,502,33,938,4,429,509,938,77079,77909,1024,2020-10-06
Molise,3,0,135,138,520,25,683,6,641,42,683,44119,45628,555,2020-10-06
Lombardia,305,41,9186,9532,81811,16973,108316,251,96143,12173,108316,1370079,2195207,8075,2020-10-05
Piemonte,273,15,3135,3423,28721,4168,36312,129,23944,12368,36312,447344,748061,3902,2020-10-05
Emilia-Romagna,213,11,4822,5046,26556,4487,36089,167,31396,4693,36089,686918,1219843,5008,2020-10-05
Veneto,182,20,4199,4401,22259,2194,28854,230,21556,7298,28854,773489,1980931,6986,2020-10-05
Lazio,764,48,7330,8142,8671,944,17757,248,8505,9252,17757,778041,937860,11402,2020-10-05
Toscana,112,32,3921,4065,10531,1168,15764,185,12297,3467,15764,523569,780067,5314,2020-10-05
Campania,463,43,7203,7709,6593,466,14768,431,13032,1736,14768,412392,632399,4867,2020-10-05
Liguria,180,24,1703,1907,10459,1610,13976,107,9913,4063,13976,174024,325764,1594,2020-10-05
Puglia,239,14,2703,2956,4762,599,8317,83,2449,5868,8317,302788,426286,1417,2020-10-05
Marche,28,6,920,954,6219,992,8165,22,8165,0,8165,150061,255176,712,2020-10-05
Sicilia,361,28,2969,3358,4130,321,7809,128,5062,2747,7809,370087,508826,2656,2020-10-05
PA Trento,17,0,633,650,5168,406,6224,49,3792,2432,6224,102111,238552,1204,2020-10-05
Friuli Venezia Giulia,23,5,840,868,3690,353,4911,21,4519,392,4911,188881,426195,1152,2020-10-05
Abruzzo,72,7,938,1017,3108,482,4607,30,3925,682,4607,133682,209580,1244,2020-10-05
Sardegna,116,19,2191,2326,1835,156,4317,88,2071,2246,4317,169073,200055,1622,2020-10-05
PA Bolzano,21,0,606,627,2743,292,3662,17,3662,0,3662,94956,183294,829,2020-10-05
Umbria,42,5,659,706,1903,86,2695,19,1713,982,2695,127714,213866,421,2020-10-05
Calabria,37,2,544,583,1402,101,2086,23,1159,927,2086,208340,210446,1360,2020-10-05
Valle d'Aosta,6,1,86,93,1107,146,1346,13,1209,137,1346,20687,29980,138,2020-10-05
Basilicata,30,2,371,403,498,33,934,14,429,505,934,76055,76885,138,2020-10-05
Molise,3,0,134,137,515,25,677,2,635,42,677,43575,45073,200,2020-10-05
Lombardia,296,39,9026,9361,81733,16971,108065,314,95940,12125,108065,1365206,2187132,14795,2020-10-04
Piemonte,216,13,3141,3370,28646,4167,36183,173,23920,12263,36183,446474,744159,5004,2020-10-04
Emilia-Romagna,212,11,4731,4954,26482,4486,35922,179,31313,4609,35922,684859,1214835,7058,2020-10-04
Veneto,178,20,4037,4235,22195,2194,28624,261,21502,7122,28624,771021,1973945,12817,2020-10-04
Lazio,737,48,7148,7933,8637,939,17509,244,8425,9084,17509,768942,926458,11737,2020-10-04
Toscana,99,26,3837,3962,10451,1166,15579,188,12196,3383,15579,519910,774753,8305,2020-10-04
Campania,450,41,6909,7400,6472,465,14337,412,12634,1703,14337,408931,627532,7250,2020-10-04
Liguria,167,23,1687,1877,10382,1610,13869,121,9843,4026,13869,173211,324170,2385,2020-10-04
Puglia,231,13,2653,2897,4739,598,8234,151,2440,5794,8234,301067,424869,3486,2020-10-04
Marche,24,6,911,941,6210,992,8143,59,8143,0,8143,149612,254464,1862,2020-10-04
Sicilia,329,24,2894,3247,4115,319,7681,85,4981,2700,7681,368405,506170,3498,2020-10-04
PA Trento,17,0,612,629,5140,406,6175,34,3786,2389,6175,101675,237348,1524,2020-10-04
Friuli Venezia Giulia,18,5,828,851,3686,353,4890,50,4503,387,4890,188339,425043,2368,2020-10-04
Abruzzo,70,6,919,995,3101,481,4577,37,3911,666,4577,132948,208336,2342,2020-10-04
Sardegna,114,20,2145,2279,1794,156,4229,111,2040,2189,4229,167736,198433,1783,2020-10-04
PA Bolzano,28,0,588,616,2737,292,3645,32,3645,0,3645,94635,182465,1106,2020-10-04
Umbria,42,4,649,695,1895,86,2676,72,1710,966,2676,127485,213445,2126,2020-10-04
Calabria,36,2,537,575,1387,101,2063,19,1159,904,2063,206980,209086,1796,2020-10-04
Valle d'Aosta,6,0,75,81,1106,146,1333,7,1197,136,1333,20588,29842,175,2020-10-04
Basilicata,15,2,373,390,497,33,920,14,426,494,920,75915,76747,800,2020-10-04
Molise,2,0,139,141,509,25,675,15,634,41,675,43376,44873,497,2020-10-04
Lombardia,293,42,8827,9162,81620,16969,107751,393,95707,12044,107751,1355640,2172337,18860,2020-10-03
Piemonte,214,12,3051,3277,28567,4166,36010,279,23810,12200,36010,442510,739155,6560,2020-10-03
Emilia-Romagna,200,11,4579,4790,26468,4485,35743,167,31230,4513,35743,680394,1207777,9867,2020-10-03
Veneto,174,21,3917,4112,22058,2193,28363,276,21482,6881,28363,765605,1961128,19891,2020-10-03
Lazio,711,47,6967,7725,8607,933,17265,261,8335,8930,17265,759903,914721,13349,2020-10-03
Toscana,99,24,3667,3790,10435,1166,15391,197,12084,3307,15391,514176,766448,8839,2020-10-03
Campania,434,40,6568,7042,6418,465,13925,401,12268,1657,13925,403167,620282,7498,2020-10-03
Liguria,167,21,1672,1860,10279,1609,13748,162,9779,3969,13748,171959,321785,4202,2020-10-03
Marche,23,6,867,896,6197,991,8084,59,8084,0,8084,148490,252602,2059,2020-10-03
Puglia,226,12,2523,2761,4724,598,8083,111,2412,5671,8083,299404,421383,3918,2020-10-03
Sicilia,322,20,2829,3171,4108,317,7596,182,4931,2665,7596,366048,502672,6638,2020-10-03
PA Trento,16,0,602,618,5117,406,6141,62,3776,2365,6141,101101,235824,2136,2020-10-03
Friuli Venezia Giulia,17,5,806,828,3659,353,4840,51,4458,382,4840,187109,422675,3900,2020-10-03
Abruzzo,66,6,890,962,3097,481,4540,42,3874,666,4540,131710,205994,2102,2020-10-03
Sardegna,113,21,2052,2186,1777,155,4118,62,2018,2100,4118,166214,196650,2069,2020-10-03
PA Bolzano,28,0,576,604,2717,292,3613,24,3613,0,3613,94145,181359,1368,2020-10-03
Umbria,41,5,588,634,1885,85,2604,42,1696,908,2604,126315,211319,2139,2020-10-03
Calabria,36,2,520,558,1386,100,2044,24,1159,885,2044,205184,207290,1902,2020-10-03
Valle d'Aosta,7,0,68,75,1105,146,1326,0,1190,136,1326,20476,29667,133,2020-10-03
Basilicata,15,2,370,387,486,33,906,49,425,481,906,75517,75947,1039,2020-10-03
Molise,3,0,125,128,507,25,660,0,620,40,660,42882,44376,463,2020-10-03
Lombardia,302,39,8825,9166,81228,16964,107358,307,95507,11851,107358,1343544,2153477,19842,2020-10-02
Piemonte,217,13,2830,3060,28505,4166,35731,219,23594,12137,35731,438901,732595,6549,2020-10-02
Emilia-Romagna,201,11,4465,4677,26416,4484,35577,163,31139,4438,35577,676766,1197910,13054,2020-10-02
Veneto,167,22,3838,4027,21871,2189,28087,191,21400,6687,28087,757440,1941237,18637,2020-10-02
Lazio,678,49,6820,7547,8529,928,17004,264,8258,8746,17004,749852,901372,11952,2020-10-02
Toscana,103,24,3504,3631,10398,1165,15194,223,11987,3207,15194,508398,757609,8873,2020-10-02
Liguria,161,23,1645,1829,10149,1608,13586,140,9687,3899,13586,169760,317583,3619,2020-10-02
Campania,439,39,6267,6745,6315,464,13524,392,11882,1642,13524,397526,612784,8482,2020-10-02
Marche,25,4,815,844,6191,990,8025,42,8025,0,8025,147169,250543,2119,2020-10-02
Puglia,223,13,2427,2663,4712,597,7972,72,2392,5580,7972,296760,417465,3949,2020-10-02
Sicilia,303,21,2724,3048,4052,314,7414,140,4821,2593,7414,362142,496034,5552,2020-10-02
PA Trento,16,0,571,587,5086,406,6079,39,3756,2323,6079,100451,233688,1731,2020-10-02
Friuli Venezia Giulia,18,2,773,793,3643,353,4789,66,4412,377,4789,185748,418775,4683,2020-10-02
Abruzzo,58,6,874,938,3079,481,4498,49,3845,653,4498,130591,203892,2408,2020-10-02
Sardegna,106,21,2027,2154,1747,155,4056,60,2003,2053,4056,164505,194581,1876,2020-10-02
PA Bolzano,28,0,559,587,2710,292,3589,21,3589,0,3589,93443,179991,1749,2020-10-02
Umbria,39,4,567,610,1867,85,2562,62,1686,876,2562,125136,209180,1925,2020-10-02
Calabria,34,1,503,538,1382,100,2020,18,1159,861,2020,203282,205388,1742,2020-10-02
Valle d'Aosta,8,0,69,77,1103,146,1326,11,1190,136,1326,20378,29534,154,2020-10-02
Basilicata,11,2,332,345,482,30,857,16,425,432,857,74088,74908,933,2020-10-02
Molise,5,0,126,131,505,24,660,4,620,40,660,42437,43913,472,2020-10-02
Lombardia,298,35,8834,9167,80924,16960,107051,324,95322,11729,107051,1331274,2133635,24691,2020-10-01
Piemonte,203,12,2692,2907,28440,4165,35512,110,23430,12082,35512,436125,726046,5073,2020-10-01
Emilia-Romagna,206,14,4434,4654,26276,4484,35414,103,31062,4352,35414,670418,1184856,8418,2020-10-01
Veneto,180,24,3761,3965,21748,2183,27896,445,21310,6586,27896,748630,1922600,18274,2020-10-01
Lazio,666,49,6628,7343,8474,923,16740,265,8177,8563,16740,740268,889420,11373,2020-10-01
Toscana,106,22,3340,3468,10338,1165,14971,144,11900,3071,14971,502556,748736,8253,2020-10-01
Liguria,152,21,1598,1771,10067,1608,13446,111,9624,3822,13446,167855,313964,3597,2020-10-01
Campania,421,38,5937,6396,6273,463,13132,390,11501,1631,13132,391374,604302,8311,2020-10-01
Marche,24,6,783,813,6180,990,7983,28,7983,0,7983,145986,248424,2137,2020-10-01
Puglia,217,14,2376,2607,4697,596,7900,114,2384,5516,7900,294298,413516,4152,2020-10-01
Sicilia,307,20,2609,2936,4026,312,7274,156,4726,2548,7274,358336,490482,6637,2020-10-01
PA Trento,15,0,579,594,5040,406,6040,48,3741,2299,6040,99722,231957,1883,2020-10-01
Friuli Venezia Giulia,20,4,735,759,3613,351,4723,57,4355,368,4723,183898,414092,4312,2020-10-01
Abruzzo,52,5,852,909,3059,481,4449,30,3799,650,4449,129248,201484,1992,2020-10-01
Sardegna,110,20,2006,2136,1705,155,3996,96,1995,2001,3996,162894,192705,2058,2020-10-01
PA Bolzano,28,0,554,582,2694,292,3568,29,3568,0,3568,92681,178242,1734,2020-10-01
Umbria,38,3,521,562,1853,85,2500,46,1681,819,2500,124094,207255,1931,2020-10-01
Calabria,32,2,503,537,1365,100,2002,17,1159,843,2002,201540,203646,1972,2020-10-01
Valle d'Aosta,7,0,62,69,1100,146,1315,1,1182,133,1315,20265,29380,254,2020-10-01
Basilicata,11,2,325,338,474,29,841,33,425,416,841,73155,73975,939,2020-10-01
Molise,4,0,130,134,498,24,656,1,616,40,656,41971,43441,245,2020-10-01
Lombardia,306,34,8720,9060,80712,16955,106727,201,95122,11605,106727,1315230,2108944,18804,2020-09-30
Piemonte,196,12,2636,2844,28394,4164,35402,170,23357,12045,35402,434855,720973,6604,2020-09-30
Emilia-Romagna,205,14,4434,4653,26174,4484,35311,101,31010,4301,35311,667137,1176438,9938,2020-09-30
Veneto,173,21,3538,3732,21541,2178,27451,155,21197,6254,27451,742361,1904326,12445,2020-09-30
Lazio,659,47,6442,7148,8409,918,16475,210,8086,8389,16475,732123,878047,10343,2020-09-30
Toscana,97,22,3283,3402,10261,1164,14827,120,11834,2993,14827,497351,740483,7703,2020-09-30
Liguria,143,22,1574,1739,9992,1604,13335,51,9556,3779,13335,166142,310367,3204,2020-09-30
Campania,414,39,5660,6113,6166,463,12742,287,11123,1619,12742,383899,595991,5584,2020-09-30
Marche,28,2,765,795,6170,990,7955,23,7955,0,7955,144940,246287,1615,2020-09-30
Puglia,218,11,2287,2516,4675,595,7786,99,2360,5426,7786,291519,409364,4577,2020-09-30
Sicilia,301,19,2546,2866,3941,311,7118,170,4641,2477,7118,354475,483845,6645,2020-09-30
PA Trento,14,0,553,567,5019,406,5992,37,3735,2257,5992,99092,230074,2420,2020-09-30
Friuli Venezia Giulia,19,6,693,718,3597,351,4666,28,4314,352,4666,182145,409780,3542,2020-09-30
Abruzzo,52,5,824,881,3057,481,4419,23,3778,641,4419,128012,199492,1778,2020-09-30
Sardegna,101,19,1941,2061,1685,154,3900,51,1958,1942,3900,161097,190647,3127,2020-09-30
PA Bolzano,28,0,533,561,2686,292,3539,17,3539,0,3539,91761,176508,1797,2020-09-30
Umbria,39,3,495,537,1832,85,2454,46,1668,786,2454,122979,205324,1940,2020-09-30
Calabria,33,2,520,555,1330,100,1985,18,1159,826,1985,199568,201674,1897,2020-09-30
Valle d'Aosta,6,0,69,75,1093,146,1314,6,1181,133,1314,20125,29126,200,2020-09-30
Basilicata,11,2,294,307,472,29,808,32,425,383,808,72216,73036,883,2020-09-30
Molise,4,0,129,133,498,24,655,6,615,40,655,41728,43196,518,2020-09-30
Lombardia,315,33,8751,9099,80476,16951,106526,203,95011,11515,106526,1303500,2090140,13791,2020-09-29
Piemonte,193,12,2527,2732,28337,4163,35232,100,23262,11970,35232,431233,714369,6660,2020-09-29
Emilia-Romagna,204,14,4492,4710,26016,4484,35210,97,30967,4243,35210,662825,1166500,10580,2020-09-29
Veneto,167,21,3483,3671,21448,2177,27296,140,21130,6166,27296,737524,1891881,11172,2020-09-29
Lazio,674,45,6330,7049,8303,913,16265,219,7999,8266,16265,724000,867704,9370,2020-09-29
Toscana,97,20,3251,3368,10175,1164,14707,56,11776,2931,14707,492445,732780,4731,2020-09-29
Liguria,143,22,1553,1718,9963,1603,13284,89,9554,3730,13284,164500,307163,2584,2020-09-29
Campania,417,35,5513,5965,6027,463,12455,286,10844,1611,12455,378937,590407,6335,2020-09-29
Marche,26,3,752,781,6161,990,7932,26,7932,0,7932,144152,244672,1540,2020-09-29
Puglia,210,14,2209,2433,4662,592,7687,76,2344,5343,7687,288503,404787,4222,2020-09-29
Sicilia,293,16,2478,2787,3851,310,6948,163,4541,2407,6948,350664,477200,6115,2020-09-29
PA Trento,11,0,576,587,4962,406,5955,13,3724,2231,5955,98077,227654,1110,2020-09-29
Friuli Venezia Giulia,21,6,697,724,3563,351,4638,28,4286,352,4638,180925,406238,2976,2020-09-29
Abruzzo,52,4,809,865,3051,481,4397,14,3764,633,4397,126999,197714,1088,2020-09-29
Sardegna,102,19,1910,2031,1667,151,3849,82,1944,1905,3849,158909,187520,1686,2020-09-29
PA Bolzano,28,0,538,566,2664,292,3522,8,3522,0,3522,91062,174711,984,2020-09-29
Umbria,39,3,478,520,1803,85,2408,23,1659,749,2408,121933,203384,2633,2020-09-29
Calabria,34,2,508,544,1323,100,1967,10,1159,808,1967,197671,199777,1387,2020-09-29
Valle d'Aosta,4,0,65,69,1093,146,1308,8,1176,132,1308,19979,28926,161,2020-09-29
Basilicata,13,1,262,276,471,29,776,6,425,351,776,71333,72153,941,2020-09-29
Molise,5,1,129,135,490,24,649,1,609,40,649,41224,42678,119,2020-09-29
Lombardia,306,31,8997,9334,80041,16948,106323,119,94891,11432,106323,1293542,2076349,7933,2020-09-28
Piemonte,180,12,2492,2684,28287,4161,35132,94,23202,11930,35132,428535,707709,3086,2020-09-28
Emilia-Romagna,201,15,4469,4685,25946,4482,35113,85,30912,4201,35113,658254,1155920,5095,2020-09-28
Veneto,155,21,3445,3621,21359,2176,27156,183,21124,6032,27156,733252,1880709,4863,2020-09-28
Lazio,640,41,6240,6921,8215,910,16046,211,7929,8117,16046,716730,858334,7906,2020-09-28
Toscana,93,22,3278,3393,10098,1160,14651,85,11759,2892,14651,489436,728049,4396,2020-09-28
Liguria,145,24,1601,1770,9825,1600,13195,109,9545,3650,13195,163180,304579,1975,2020-09-28
Campania,412,30,5298,5740,5968,461,12169,295,10572,1597,12169,374216,584072,5592,2020-09-28
Marche,25,4,733,762,6154,990,7906,5,7906,0,7906,143293,243132,382,2020-09-28
Puglia,214,15,2190,2419,4600,592,7611,90,2337,5274,7611,285597,400565,1456,2020-09-28
Sicilia,294,15,2434,2743,3733,309,6785,102,4458,2327,6785,346506,471085,2414,2020-09-28
PA Trento,11,0,604,615,4921,406,5942,20,3721,2221,5942,97622,226544,208,2020-09-28
Friuli Venezia Giulia,18,6,697,721,3538,351,4610,2,4261,349,4610,179938,403262,700,2020-09-28
Abruzzo,54,4,799,857,3048,479,4384,4,3763,621,4384,126392,196626,189,2020-09-28
Sardegna,109,17,1843,1969,1648,150,3767,37,1932,1835,3767,157411,185834,1335,2020-09-28
PA Bolzano,26,0,534,560,2662,292,3514,25,3514,0,3514,90576,173727,1000,2020-09-28
Umbria,38,3,467,508,1792,85,2385,11,1655,730,2385,120628,200751,601,2020-09-28
Calabria,36,2,508,546,1311,100,1957,5,1159,798,1957,196284,198390,975,2020-09-28
Valle d'Aosta,3,0,62,65,1089,146,1300,1,1169,131,1300,19888,28765,103,2020-09-28
Basilicata,13,1,259,273,468,29,770,7,425,345,770,70392,71212,186,2020-09-28
Molise,4,1,132,137,487,24,648,4,608,40,648,41105,42559,714,2020-09-28
Lombardia,302,31,8904,9237,80021,16946,106204,216,94827,11377,106204,1288690,2068416,16567,2020-09-27
Piemonte,166,10,2457,2633,28244,4161,35038,132,23230,11808,35038,426733,704623,4274,2020-09-27
Emilia-Romagna,201,15,4466,4682,25864,4482,35028,96,30863,4165,35028,655624,1150825,9295,2020-09-27
Veneto,148,21,3321,3490,21307,2176,26973,159,21088,5885,26973,731147,1875846,9683,2020-09-27
Lazio,610,38,6161,6809,8119,907,15835,181,7866,7969,15835,710057,850428,8851,2020-09-27
Toscana,82,23,3302,3407,10002,1157,14566,101,11728,2838,14566,486576,723653,7541,2020-09-27
Liguria,137,22,1579,1738,9749,1599,13086,45,9481,3605,13086,162174,302604,1908,2020-09-27
Campania,400,30,5160,5590,5824,460,11874,245,10290,1584,11874,371640,578480,5539,2020-09-27
Marche,20,2,738,760,6151,990,7901,24,7901,0,7901,143076,242750,1599,2020-09-27
Puglia,210,12,2182,2404,4527,590,7521,76,2331,5190,7521,283877,399109,2683,2020-09-27
Sicilia,268,14,2377,2659,3716,308,6683,107,4398,2285,6683,345016,468671,4202,2020-09-27
PA Trento,12,0,586,598,4919,405,5922,42,3713,2209,5922,97509,226336,1542,2020-09-27
Friuli Venezia Giulia,18,6,696,720,3537,351,4608,28,4259,349,4608,179595,402562,2344,2020-09-27
Abruzzo,50,5,807,862,3040,478,4380,47,3759,621,4380,126265,196437,2188,2020-09-27
Sardegna,110,18,1836,1964,1617,149,3730,139,1926,1804,3730,156237,184499,2485,2020-09-27
PA Bolzano,26,0,521,547,2650,292,3489,22,3489,0,3489,90172,172727,2242,2020-09-27
Umbria,33,3,465,501,1788,85,2374,21,1651,723,2374,120300,200150,2065,2020-09-27
Calabria,35,2,507,544,1308,100,1952,31,1159,793,1952,195309,197415,1870,2020-09-27
Valle d'Aosta,3,0,63,66,1087,146,1299,0,1168,131,1299,19826,28662,178,2020-09-27
Basilicata,13,1,252,266,468,29,763,47,425,338,763,70206,71026,519,2020-09-27
Molise,2,1,138,141,479,24,644,7,604,40,644,40403,41845,139,2020-09-27
Lombardia,312,30,8745,9087,79960,16941,105988,256,94691,11297,105988,1278033,2051849,19137,2020-09-26
Emilia-Romagna,200,17,4500,4717,25734,4481,34932,99,30821,4111,34932,651887,1141530,10107,2020-09-26
Piemonte,164,10,2389,2563,28183,4160,34906,107,23264,11642,34906,423689,700349,5417,2020-09-26
Veneto,147,21,3264,3432,21208,2174,26814,216,21048,5766,26814,727456,1866163,16415,2020-09-26
Lazio,591,35,6041,6667,8081,906,15654,219,7797,7857,15654,703206,841577,9791,2020-09-26
Toscana,84,24,3219,3327,9981,1157,14465,110,11683,2782,14465,481455,716112,6953,2020-09-26
Liguria,136,19,1582,1737,9705,1599,13041,97,9448,3593,13041,161282,300696,3016,2020-09-26
Campania,325,29,5127,5481,5688,460,11629,274,10058,1571,11629,367291,572941,6104,2020-09-26
Marche,23,2,716,741,6146,990,7877,26,7877,0,7877,142155,241151,1578,2020-09-26
Puglia,203,11,2123,2337,4518,590,7445,51,2316,5129,7445,282195,396426,3514,2020-09-26
Sicilia,255,13,2315,2583,3687,306,6576,110,4341,2235,6576,342008,464469,5558,2020-09-26
PA Trento,14,0,549,563,4912,405,5880,51,3711,2169,5880,96818,224794,2116,2020-09-26
Friuli Venezia Giulia,18,6,694,718,3512,350,4580,54,4240,340,4580,178499,400218,4475,2020-09-26
Abruzzo,54,5,762,821,3035,477,4333,16,3717,616,4333,124985,194249,1696,2020-09-26
Sardegna,109,18,1709,1836,1607,148,3591,63,1891,1700,3591,154219,182014,1904,2020-09-26
PA Bolzano,26,0,514,540,2635,292,3467,29,3467,0,3467,89488,170485,1479,2020-09-26
Umbria,34,3,463,500,1768,85,2353,35,1646,707,2353,118947,198085,2008,2020-09-26
Calabria,30,2,481,513,1308,100,1921,15,1159,762,1921,193439,195545,1764,2020-09-26
Valle d'Aosta,3,0,63,66,1087,146,1299,11,1168,131,1299,19697,28484,152,2020-09-26
Basilicata,14,1,214,229,459,28,716,25,425,291,716,69687,70507,830,2020-09-26
Molise,4,1,130,135,479,23,637,5,597,40,637,40259,41706,373,2020-09-26
Lombardia,300,30,8841,9171,79624,16937,105732,277,94550,11182,105732,1265754,2032712,20431,2020-09-25
Emilia-Romagna,189,18,4444,4651,25701,4481,34833,122,30776,4057,34833,647139,1131423,10040,2020-09-25
Piemonte,163,9,2330,2502,28138,4159,34799,120,23289,11510,34799,420303,694932,6284,2020-09-25
Veneto,140,19,3177,3336,21089,2173,26598,196,20994,5604,26598,721936,1849748,14188,2020-09-25
Lazio,563,36,5892,6491,8040,904,15435,230,7739,7696,15435,695956,831786,11026,2020-09-25
Toscana,87,24,3150,3261,9938,1156,14355,139,11622,2733,14355,477064,709159,7245,2020-09-25
Liguria,145,17,1564,1726,9621,1597,12944,73,9400,3544,12944,159717,297680,2753,2020-09-25
Campania,382,27,4849,5258,5638,459,11355,253,9798,1557,11355,362048,566837,7579,2020-09-25
Marche,22,2,697,721,6140,990,7851,33,7851,0,7851,141222,239573,1547,2020-09-25
Puglia,208,10,2091,2309,4498,587,7394,90,2304,5090,7394,279402,392912,3299,2020-09-25
Sicilia,235,13,2282,2530,3630,306,6466,107,4281,2185,6466,337774,458911,5330,2020-09-25
PA Trento,13,0,535,548,4876,405,5829,23,3699,2130,5829,95829,222678,2155,2020-09-25
Friuli Venezia Giulia,17,6,690,713,3463,350,4526,37,4192,334,4526,177070,395743,3899,2020-09-25
Abruzzo,58,5,754,817,3023,477,4317,51,3709,608,4317,124138,192553,1626,2020-09-25
Sardegna,112,19,1653,1784,1596,148,3528,57,1874,1654,3528,152652,180110,1956,2020-09-25
PA Bolzano,20,1,493,514,2632,292,3438,52,3438,0,3438,88792,169006,2698,2020-09-25
Umbria,32,3,450,485,1748,85,2318,23,1641,677,2318,117862,196077,1861,2020-09-25
Calabria,32,3,473,508,1300,98,1906,10,1159,747,1906,191675,193781,1908,2020-09-25
Valle d'Aosta,3,0,52,55,1087,146,1288,1,1158,130,1288,19587,28332,100,2020-09-25
Basilicata,13,1,191,205,458,28,691,13,423,268,691,68857,69677,850,2020-09-25
Molise,3,1,129,133,476,23,632,5,592,40,632,39893,41333,494,2020-09-25
Lombardia,303,31,8714,9048,79472,16935,105455,229,94409,11046,105455,1252897,2012281,21369,2020-09-24
Emilia-Romagna,192,20,4415,4627,25604,4480,34711,99,30716,3995,34711,643017,1121383,11096,2020-09-24
Piemonte,165,9,2288,2462,28059,4158,34679,104,23374,11305,34679,417396,688648,6366,2020-09-24
Veneto,144,17,3111,3272,20961,2169,26402,248,20912,5490,26402,717052,1835560,15459,2020-09-24
Lazio,544,35,5768,6347,7956,902,15205,230,7676,7529,15205,686623,820760,9951,2020-09-24
Toscana,95,24,3037,3156,9907,1153,14216,156,11569,2647,14216,472376,701914,7710,2020-09-24
Liguria,153,18,1483,1654,9621,1596,12871,102,9393,3478,12871,158350,294927,2991,2020-09-24
Campania,371,25,4761,5157,5488,457,11102,195,9568,1534,11102,355075,559258,7027,2020-09-24
Marche,25,3,672,700,6129,989,7818,17,7818,0,7818,140335,238026,1512,2020-09-24
Puglia,207,10,2046,2263,4455,586,7304,73,2287,5017,7304,276895,389613,4123,2020-09-24
Sicilia,237,16,2208,2461,3594,304,6359,125,4221,2138,6359,334504,453581,5169,2020-09-24
PA Trento,14,0,535,549,4852,405,5806,23,3696,2110,5806,94954,220523,1612,2020-09-24
Friuli Venezia Giulia,21,6,680,707,3432,350,4489,28,4158,331,4489,175810,391844,3034,2020-09-24
Abruzzo,50,4,716,770,3019,477,4266,17,3683,583,4266,123127,190927,1875,2020-09-24
Sardegna,112,18,1632,1762,1561,148,3471,66,1859,1612,3471,151015,178154,2325,2020-09-24
PA Bolzano,20,1,464,485,2609,292,3386,20,3386,0,3386,87710,166308,1542,2020-09-24
Umbria,30,3,442,475,1735,85,2295,29,1629,666,2295,116814,194216,1692,2020-09-24
Calabria,29,4,467,500,1298,98,1896,9,1159,737,1896,189767,191873,1842,2020-09-24
Valle d'Aosta,3,0,53,56,1085,146,1287,3,1157,130,1287,19525,28232,255,2020-09-24
Basilicata,13,1,182,196,454,28,678,9,423,255,678,68007,68827,746,2020-09-24
Molise,3,1,129,133,471,23,627,4,587,40,627,39412,40839,323,2020-09-24
Lombardia,308,33,8763,9104,79197,16925,105226,196,94288,10938,105226,1239028,1990912,22805,2020-09-23
Emilia-Romagna,187,20,4406,4613,25520,4479,34612,101,30673,3939,34612,636603,1110287,10061,2020-09-23
Piemonte,163,8,2247,2418,28000,4157,34575,95,23482,11093,34575,413848,682282,5620,2020-09-23
Veneto,139,16,3000,3155,20832,2167,26154,150,20835,5319,26154,711874,1820101,11967,2020-09-23
Lazio,521,32,5631,6184,7889,902,14975,195,7603,7372,14975,678371,810809,9112,2020-09-23
Toscana,97,24,2933,3054,9853,1153,14060,90,11493,2567,14060,467414,694204,7502,2020-09-23
Liguria,149,18,1426,1593,9582,1594,12769,108,9352,3417,12769,156756,291936,3766,2020-09-23
Campania,356,22,4689,5067,5383,457,10907,248,9379,1528,10907,350063,552231,3901,2020-09-23
Marche,24,4,658,686,6126,989,7801,32,7801,0,7801,139445,236514,1497,2020-09-23
Puglia,204,10,2008,2222,4426,583,7231,89,2271,4960,7231,274285,385490,4014,2020-09-23
Sicilia,230,16,2166,2412,3519,303,6234,89,4141,2093,6234,331383,448412,6039,2020-09-23
PA Trento,13,0,547,560,4818,405,5783,22,3685,2098,5783,94533,218911,2227,2020-09-23
Friuli Venezia Giulia,16,6,688,710,3401,350,4461,57,4136,325,4461,174659,388810,4770,2020-09-23
Abruzzo,55,4,701,760,3012,477,4249,22,3689,560,4249,122050,189052,1848,2020-09-23
Sardegna,100,21,1624,1745,1515,145,3405,49,1826,1579,3405,149069,175829,2169,2020-09-23
PA Bolzano,20,1,455,476,2598,292,3366,37,3366,0,3366,86974,164766,1426,2020-09-23
Umbria,30,3,435,468,1713,85,2266,19,1620,646,2266,115748,192524,1881,2020-09-23
Calabria,27,4,474,505,1284,98,1887,19,1159,728,1887,187925,190031,1893,2020-09-23
Valle d'Aosta,4,0,54,58,1080,146,1284,2,1154,130,1284,19381,27977,105,2020-09-23
Basilicata,12,1,179,192,449,28,669,17,422,247,669,67261,68081,577,2020-09-23
Molise,3,1,128,132,468,23,623,3,583,40,623,39092,40516,516,2020-09-23
Lombardia,294,34,8699,9027,79078,16925,105030,182,94164,10866,105030,1225067,1968107,14808,2020-09-22
Emilia-Romagna,185,22,4426,4633,25400,4478,34511,56,30622,3889,34511,631253,1100226,9791,2020-09-22
Piemonte,164,7,2222,2393,27931,4156,34480,84,23572,10908,34480,411192,676662,5963,2020-09-22
Veneto,141,14,2988,3143,20696,2165,26004,119,20745,5259,26004,707232,1808134,10035,2020-09-22
Lazio,482,31,5517,6030,7851,899,14780,238,7552,7228,14780,669956,801697,9022,2020-09-22
Toscana,98,21,2939,3058,9760,1152,13970,74,11457,2513,13970,462715,686702,5632,2020-09-22
Liguria,148,17,1365,1530,9539,1592,12661,105,9308,3353,12661,154818,288170,2642,2020-09-22
Campania,360,23,4572,4955,5247,457,10659,156,9137,1522,10659,345740,548330,4310,2020-09-22
Marche,24,3,633,660,6120,989,7769,18,7769,0,7769,138616,235017,1061,2020-09-22
Puglia,204,10,1976,2190,4371,581,7142,67,2253,4889,7142,271426,381476,4516,2020-09-22
Sicilia,224,15,2151,2390,3455,300,6145,108,4087,2058,6145,327407,442373,7008,2020-09-22
PA Trento,13,0,535,548,4808,405,5761,25,3679,2082,5761,93785,216684,999,2020-09-22
Friuli Venezia Giulia,21,5,677,703,3351,350,4404,14,4092,312,4404,173067,384040,2296,2020-09-22
Abruzzo,54,5,683,742,3010,475,4227,18,3669,558,4227,120852,187204,1122,2020-09-22
Sardegna,96,21,1606,1723,1490,143,3356,53,1809,1547,3356,147183,173660,2183,2020-09-22
PA Bolzano,20,1,427,448,2589,292,3329,8,3329,0,3329,86311,163340,1005,2020-09-22
Umbria,28,4,437,469,1694,84,2247,26,1616,631,2247,114754,190643,2443,2020-09-22
Calabria,29,4,457,490,1280,98,1868,24,1159,709,1868,186032,188138,1531,2020-09-22
Valle d'Aosta,4,0,45,49,1087,146,1282,1,1152,130,1282,19320,27872,157,2020-09-22
Basilicata,10,1,166,177,447,28,652,14,422,230,652,66694,67504,577,2020-09-22
Molise,5,1,125,131,466,23,620,2,580,40,620,38579,40000,202,2020-09-22
Lombardia,283,36,8757,9076,78849,16923,104848,90,94073,10775,104848,1213246,1953299,9963,2020-09-21
Emilia-Romagna,167,23,4428,4618,25361,4477,34456,116,30587,3869,34456,627269,1090435,5024,2020-09-21
Piemonte,143,7,2208,2358,27883,4155,34396,57,23667,10729,34396,410265,670699,2387,2020-09-21
Veneto,129,12,2993,3134,20589,2162,25885,103,20693,5192,25885,703443,1798099,6595,2020-09-21
Lazio,466,27,5347,5840,7807,895,14542,198,7467,7075,14542,662743,792675,8286,2020-09-21
Toscana,94,23,2901,3018,9726,1152,13896,84,11423,2473,13896,459147,681070,4138,2020-09-21
Liguria,145,15,1365,1525,9440,1591,12556,64,9281,3275,12556,153324,285528,1353,2020-09-21
Campania,345,21,4531,4897,5149,457,10503,243,8987,1516,10503,345005,544020,3405,2020-09-21
Marche,24,2,624,650,6112,989,7751,17,7751,0,7751,137930,233956,550,2020-09-21
Puglia,201,11,1977,2189,4306,580,7075,81,2238,4837,7075,268745,376960,1895,2020-09-21
Sicilia,203,14,2131,2348,3390,299,6037,75,4027,2010,6037,323104,435365,3102,2020-09-21
PA Trento,13,0,545,558,4773,405,5736,2,3674,2062,5736,93200,215685,118,2020-09-21
Friuli Venezia Giulia,20,5,671,696,3344,350,4390,13,4084,306,4390,172262,381744,886,2020-09-21
Abruzzo,58,5,676,739,2995,475,4209,72,3657,552,4209,120157,186082,3976,2020-09-21
PA Bolzano,16,1,423,440,2589,292,3321,20,3321,0,3321,85880,162335,1126,2020-09-21
Sardegna,98,20,1596,1714,1446,143,3303,64,1787,1516,3303,145340,171477,1082,2020-09-21
Umbria,25,4,439,468,1669,84,2221,5,1612,609,2221,113380,188200,593,2020-09-21
Calabria,30,4,434,468,1278,98,1844,12,1159,685,1844,184501,186607,920,2020-09-21
Valle d'Aosta,3,0,45,48,1087,146,1281,2,1151,130,1281,19210,27715,124,2020-09-21
Basilicata,7,1,155,163,447,28,638,1,420,218,638,66117,66927,82,2020-09-21
Molise,5,1,126,132,463,23,618,31,579,39,618,38386,39798,257,2020-09-21
Lombardia,264,38,8705,9007,78829,16922,104758,211,93998,10760,104758,1206551,1943336,14926,2020-09-20
Emilia-Romagna,169,19,4341,4529,25335,4476,34340,115,30531,3809,34340,625160,1085411,7635,2020-09-20
Piemonte,142,7,2177,2326,27859,4154,34339,98,23698,10641,34339,407611,668312,5221,2020-09-20
Veneto,124,10,2959,3093,20527,2162,25782,173,20655,5127,25782,701455,1791504,10952,2020-09-20
Lazio,422,23,5244,5689,7765,890,14344,165,7410,6934,14344,655297,784389,9464,2020-09-20
Toscana,86,23,2847,2956,9704,1152,13812,147,11394,2418,13812,455978,676932,8036,2020-09-20
Liguria,136,15,1310,1461,9440,1591,12492,85,9293,3199,12492,152634,284175,2049,2020-09-20
Campania,344,22,4309,4675,5129,456,10260,171,8758,1502,10260,339764,540615,7632,2020-09-20
Marche,21,2,619,642,6103,989,7734,31,7734,0,7734,137510,233406,1457,2020-09-20
Puglia,199,11,1918,2128,4287,579,6994,50,2234,4760,6994,267208,375065,2777,2020-09-20
Sicilia,194,13,2109,2316,3350,296,5962,116,4002,1960,5962,321168,432263,3120,2020-09-20
PA Trento,13,0,544,557,4772,405,5734,45,3673,2061,5734,93131,215567,1547,2020-09-20
Friuli Venezia Giulia,19,4,663,686,3341,350,4377,32,4074,303,4377,171811,380858,2069,2020-09-20
Abruzzo,48,5,626,679,2984,474,4137,0,3603,534,4137,117719,182106,0,2020-09-20
PA Bolzano,15,2,405,422,2587,292,3301,20,3301,0,3301,85316,161209,1530,2020-09-20
Sardegna,96,18,1551,1665,1433,141,3239,72,1776,1463,3239,144511,170395,1276,2020-09-20
Umbria,29,4,452,485,1648,83,2216,24,1607,609,2216,113041,187607,1300,2020-09-20
Calabria,30,4,427,461,1273,98,1832,22,1159,673,1832,183581,185687,1632,2020-09-20
Valle d'Aosta,4,0,47,51,1082,146,1279,3,1149,130,1279,19140,27591,176,2020-09-20
Basilicata,6,1,159,166,443,28,637,6,420,217,637,66035,66845,327,2020-09-20
Molise,4,1,99,104,460,23,587,1,548,39,587,38140,39541,302,2020-09-20
Lombardia,271,36,8628,8935,78695,16917,104547,243,93866,10681,104547,1197038,1928410,21721,2020-09-19
Piemonte,140,6,2158,2304,27783,4154,34241,74,23816,10425,34241,403513,663091,3848,2020-09-19
Emilia-Romagna,174,19,4245,4438,25313,4474,34225,133,30466,3759,34225,620451,1077776,8998,2020-09-19
Veneto,125,10,2910,3045,20406,2158,25609,186,20627,4982,25609,697466,1780552,16684,2020-09-19
Lazio,445,22,5071,5538,7751,890,14179,197,7376,6803,14179,646453,774925,10097,2020-09-19
Toscana,88,21,2718,2827,9686,1152,13665,143,11342,2323,13665,450613,668896,8651,2020-09-19
Liguria,140,16,1277,1433,9386,1588,12407,78,9219,3188,12407,151550,282126,2666,2020-09-19
Campania,327,19,4227,4573,5060,456,10089,149,8599,1490,10089,333778,532983,5515,2020-09-19
Marche,23,2,596,621,6093,989,7703,24,7703,0,7703,136589,231949,1458,2020-09-19
Puglia,201,13,1874,2088,4278,578,6944,108,2227,4717,6944,265618,372288,3717,2020-09-19
Sicilia,191,13,2028,2232,3318,296,5846,98,3929,1917,5846,318845,429143,4344,2020-09-19
PA Trento,10,0,524,534,4750,405,5689,22,3653,2036,5689,92546,214020,2375,2020-09-19
Friuli Venezia Giulia,20,3,658,681,3314,350,4345,33,4045,300,4345,170885,378789,3639,2020-09-19
Abruzzo,48,5,626,679,2984,474,4137,0,3603,534,4137,117719,182106,0,2020-09-19
PA Bolzano,15,2,388,405,2584,292,3281,26,3281,0,3281,84628,159679,2281,2020-09-19
Sardegna,91,18,1486,1595,1431,141,3167,59,1757,1410,3167,143431,169119,2396,2020-09-19
Umbria,27,4,440,471,1638,83,2192,32,1601,591,2192,112361,186307,1767,2020-09-19
Calabria,27,4,414,445,1267,98,1810,25,1159,651,1810,181949,184055,1880,2020-09-19
Valle d'Aosta,6,0,42,48,1082,146,1276,0,1146,130,1276,19040,27415,225,2020-09-19
Basilicata,6,1,158,165,438,28,631,3,415,216,631,65708,66518,634,2020-09-19
Molise,5,1,98,104,459,23,586,5,547,39,586,37847,39239,327,2020-09-19
Lombardia,284,32,8711,9027,78369,16908,104304,224,93748,10556,104304,1184027,1906689,16828,2020-09-18
Piemonte,140,6,2116,2262,27752,4153,34167,127,23856,10311,34167,401619,659243,4786,2020-09-18
Emilia-Romagna,182,21,4166,4369,25252,4472,34093,121,30405,3688,34093,616330,1068778,9674,2020-09-18
Veneto,115,8,2886,3009,20261,2153,25423,176,20564,4859,25423,691678,1763868,11985,2020-09-18
Lazio,459,17,4937,5413,7680,889,13982,193,7306,6676,13982,637844,764828,10558,2020-09-18
Toscana,95,21,2584,2700,9670,1152,13522,99,11271,2251,13522,444645,660245,7883,2020-09-18
Liguria,141,16,1257,1414,9329,1586,12329,158,9217,3112,12329,150104,279460,3955,2020-09-18
Campania,318,20,4127,4465,5020,455,9940,208,8456,1484,9940,328713,527468,7460,2020-09-18
Marche,22,1,583,606,6084,989,7679,29,7679,0,7679,135887,230491,1519,2020-09-18
Puglia,200,12,1774,1986,4273,577,6836,84,2207,4629,6836,263073,368571,3773,2020-09-18
Sicilia,179,15,1963,2157,3295,296,5748,179,3859,1889,5748,316122,424799,6329,2020-09-18
PA Trento,12,0,546,558,4704,405,5667,18,3645,2022,5667,91799,211645,1793,2020-09-18
Friuli Venezia Giulia,22,4,646,672,3291,349,4312,39,4017,295,4312,169788,375150,3152,2020-09-18
Abruzzo,48,5,626,679,2984,474,4137,54,3603,534,4137,117719,182106,1804,2020-09-18
PA Bolzano,15,2,368,385,2578,292,3255,72,3255,0,3255,83325,157398,1916,2020-09-18
Sardegna,89,17,1461,1567,1400,141,3108,66,1750,1358,3108,141571,166723,1938,2020-09-18
Umbria,27,5,423,455,1623,82,2160,21,1592,568,2160,111396,184540,1684,2020-09-18
Calabria,24,4,393,421,1266,98,1785,28,1159,626,1785,180069,182175,1777,2020-09-18
Valle d'Aosta,6,0,43,49,1081,146,1276,8,1146,130,1276,18953,27190,82,2020-09-18
Basilicata,6,1,156,163,437,28,628,0,415,213,628,65074,65884,438,2020-09-18
Molise,3,1,96,100,458,23,581,3,542,39,581,37522,38912,505,2020-09-18
Lombardia,272,32,8630,8934,78240,16906,104080,281,93616,10464,104080,1173781,1889861,21707,2020-09-17
Piemonte,136,6,2080,2222,27665,4153,34040,70,23925,10115,34040,399601,654457,4872,2020-09-17
Emilia-Romagna,178,21,4078,4277,25224,4471,33972,110,30355,3617,33972,612312,1059104,8414,2020-09-17
Veneto,109,12,2843,2964,20132,2151,25247,109,20476,4771,25247,687364,1751883,11579,2020-09-17
Lazio,492,16,4775,5283,7617,889,13789,181,7259,6530,13789,629051,754270,9381,2020-09-17
Toscana,89,20,2541,2650,9621,1152,13423,119,11228,2195,13423,439124,652362,7717,2020-09-17
Liguria,135,15,1208,1358,9227,1586,12171,40,9080,3091,12171,148192,275505,2295,2020-09-17
Campania,302,21,3984,4307,4970,455,9732,195,8380,1352,9732,321975,520008,8473,2020-09-17
Marche,20,2,560,582,6079,989,7650,37,7650,0,7650,135016,228972,1695,2020-09-17
Puglia,200,14,1701,1915,4262,575,6752,63,2191,4561,6752,260264,364798,4011,2020-09-17
PA Trento,11,0,560,571,4673,405,5649,76,3633,2016,5649,91333,209852,2099,2020-09-17
Sicilia,173,14,1856,2043,3231,295,5569,96,3750,1819,5569,312007,418470,5498,2020-09-17
Friuli Venezia Giulia,22,4,630,656,3268,349,4273,63,3988,285,4273,168808,371998,4081,2020-09-17
Abruzzo,45,5,582,632,2978,473,4083,33,3559,524,4083,116740,180302,1746,2020-09-17
PA Bolzano,15,2,309,326,2565,292,3183,15,3183,0,3183,82321,155482,1529,2020-09-17
Sardegna,84,17,1413,1514,1388,140,3042,51,1735,1307,3042,140077,164785,1949,2020-09-17
Umbria,25,5,437,467,1590,82,2139,22,1585,554,2139,110422,182856,1759,2020-09-17
Calabria,26,4,375,405,1254,98,1757,16,1159,598,1757,178292,180398,1845,2020-09-17
Valle d'Aosta,5,0,36,41,1081,146,1268,1,1138,130,1268,18904,27108,273,2020-09-17
Basilicata,6,1,159,166,434,28,628,5,415,213,628,64636,65446,583,2020-09-17
Molise,3,1,96,100,455,23,578,2,540,38,578,37023,38407,267,2020-09-17
Lombardia,264,30,8510,8804,78090,16905,103799,159,93456,10343,103799,1160353,1868154,17831,2020-09-16
Piemonte,123,6,2098,2227,27590,4153,33970,117,23957,10013,33970,397218,649585,4961,2020-09-16
Emilia-Romagna,174,19,3986,4179,25213,4470,33862,106,30293,3569,33862,607881,1050690,10024,2020-09-16
Veneto,107,14,2869,2990,19997,2151,25138,159,20393,4745,25138,683212,1740304,16413,2020-09-16
Lazio,467,18,4643,5128,7593,887,13608,165,7208,6400,13608,621049,744889,7911,2020-09-16
Toscana,88,20,2480,2588,9565,1151,13304,90,11177,2127,13304,433964,644645,6574,2020-09-16
Liguria,136,13,1174,1323,9225,1583,12131,73,9085,3046,12131,147046,273210,3335,2020-09-16
Campania,301,19,3877,4197,4888,452,9537,186,8213,1324,9537,315063,511535,6072,2020-09-16
Marche,15,2,544,561,6063,989,7613,38,7613,0,7613,134034,227277,1346,2020-09-16
Puglia,204,14,1645,1863,4252,574,6689,103,2179,4510,6689,257428,360787,4571,2020-09-16
PA Trento,13,0,488,501,4667,405,5573,32,3624,1949,5573,90609,207753,2528,2020-09-16
Sicilia,155,16,1817,1988,3190,295,5473,90,3690,1783,5473,308515,412972,5809,2020-09-16
Friuli Venezia Giulia,22,3,587,612,3249,349,4210,29,3949,261,4210,167456,367917,4227,2020-09-16
Abruzzo,42,5,559,606,2973,473,4052,18,3533,519,4052,115700,178556,1577,2020-09-16
PA Bolzano,17,2,304,323,2553,292,3168,12,3168,0,3168,81388,153953,1277,2020-09-16
Sardegna,88,17,1375,1480,1371,140,2991,27,1728,1263,2991,138426,162836,1818,2020-09-16
Umbria,27,5,436,468,1568,81,2117,17,1583,534,2117,109462,181097,1798,2020-09-16
Calabria,28,2,359,389,1254,98,1741,19,1159,582,1741,176447,178553,1669,2020-09-16
Valle d'Aosta,5,0,37,42,1079,146,1267,1,1137,130,1267,18731,26835,137,2020-09-16
Basilicata,6,1,157,164,431,28,623,5,414,209,623,64053,64863,533,2020-09-16
Molise,3,1,95,99,454,23,576,6,538,38,576,36757,38140,196,2020-09-16
Lombardia,263,29,8507,8799,77938,16903,103640,176,93359,10281,103640,1148425,1850323,19399,2020-09-15
Piemonte,112,8,2037,2157,27543,4153,33853,39,23962,9891,33853,394783,644624,3739,2020-09-15
Emilia-Romagna,168,17,3917,4102,25184,4470,33756,125,30239,3517,33756,603369,1040666,9885,2020-09-15
Veneto,102,15,2867,2984,19849,2146,24979,115,20368,4611,24979,677256,1723891,8122,2020-09-15
Lazio,453,18,4526,4997,7559,887,13443,139,7165,6278,13443,614394,736978,7727,2020-09-15
Toscana,93,17,2417,2527,9536,1151,13214,41,11151,2063,13214,429310,638071,4493,2020-09-15
Liguria,128,12,1111,1251,9225,1582,12058,141,9060,2998,12058,145476,269875,2445,2020-09-15
Campania,295,18,3767,4080,4819,452,9351,136,8041,1310,9351,310227,505463,3895,2020-09-15
Marche,17,2,517,536,6050,989,7575,14,7575,0,7575,133279,225931,1259,2020-09-15
Puglia,204,13,1559,1776,4237,573,6586,76,2160,4426,6586,255154,356216,4677,2020-09-15
PA Trento,9,0,465,474,4662,405,5541,20,3613,1928,5541,89798,205225,621,2020-09-15
Sicilia,141,17,1761,1919,3172,292,5383,77,3640,1743,5383,304795,407163,4327,2020-09-15
Friuli Venezia Giulia,24,2,583,609,3223,349,4181,20,3924,257,4181,166049,363690,2157,2020-09-15
Abruzzo,42,4,545,591,2970,473,4034,18,3520,514,4034,114687,176979,1019,2020-09-15
PA Bolzano,15,1,304,320,2544,292,3156,21,3156,0,3156,80736,152676,855,2020-09-15
Sardegna,86,18,1353,1457,1367,140,2964,36,1721,1243,2964,136896,161018,1616,2020-09-15
Umbria,23,6,430,459,1560,81,2100,22,1581,519,2100,108521,179299,2190,2020-09-15
Calabria,31,2,341,374,1250,98,1722,4,1159,563,1722,174778,176884,1185,2020-09-15
Valle d'Aosta,5,0,37,42,1078,146,1266,3,1135,131,1266,18657,26698,170,2020-09-15
Basilicata,6,1,154,161,429,28,618,5,414,204,618,63520,64330,497,2020-09-15
Molise,5,1,91,97,450,23,570,1,532,38,570,36565,37944,239,2020-09-15
Lombardia,262,28,8558,8848,77715,16901,103464,125,93294,10170,103464,1134109,1830924,7931,2020-09-14
Piemonte,114,9,2006,2129,27532,4153,33814,61,23990,9824,33814,393413,640885,2834,2020-09-14
Emilia-Romagna,165,18,3881,4064,25098,4469,33631,127,30178,3453,33631,599934,1030781,4849,2020-09-14
Veneto,96,14,2873,2983,19737,2144,24864,55,20329,4535,24864,673892,1715769,4261,2020-09-14
Lazio,410,17,4469,4896,7523,885,13304,181,7136,6168,13304,606736,729251,8818,2020-09-14
Toscana,82,18,2400,2500,9523,1150,13173,59,11136,2037,13173,426415,633578,3377,2020-09-14
Liguria,126,12,1062,1200,9135,1582,11917,65,9030,2887,11917,144077,267430,995,2020-09-14
Campania,286,19,3699,4004,4759,452,9215,90,7915,1300,9215,306866,501568,2845,2020-09-14
Marche,15,2,511,528,6044,989,7561,11,7561,0,7561,132543,224672,553,2020-09-14
Puglia,203,11,1499,1713,4225,572,6510,61,2151,4359,6510,252699,351539,1820,2020-09-14
PA Trento,11,0,448,459,4657,405,5521,20,3610,1911,5521,89459,204604,317,2020-09-14
Sicilia,136,16,1690,1842,3172,292,5306,65,3593,1713,5306,301876,402836,2158,2020-09-14
Friuli Venezia Giulia,22,3,567,592,3220,349,4161,4,3910,251,4161,165276,361533,832,2020-09-14
Abruzzo,41,4,532,577,2966,473,4016,1,3507,509,4016,114031,175960,106,2020-09-14
PA Bolzano,8,0,295,303,2540,292,3135,7,3135,0,3135,80293,151821,699,2020-09-14
Sardegna,85,16,1339,1440,1348,140,2928,54,1718,1210,2928,135511,159402,1322,2020-09-14
Umbria,19,5,419,443,1554,81,2078,12,1574,504,2078,107533,177109,592,2020-09-14
Calabria,29,2,344,375,1245,98,1718,3,1159,559,1718,173593,175699,674,2020-09-14
Valle d'Aosta,3,1,35,39,1078,146,1263,3,1132,131,1263,18560,26528,39,2020-09-14
Basilicata,5,1,150,156,429,28,613,0,414,199,613,63023,63833,62,2020-09-14
Molise,4,1,91,96,450,23,569,4,531,38,569,36332,37705,225,2020-09-14
Lombardia,252,28,8509,8789,77651,16899,103339,265,93207,10132,103339,1128937,1822993,12844,2020-09-13
Piemonte,100,8,1989,2097,27503,4153,33753,82,23979,9774,33753,391637,638051,3728,2020-09-13
Emilia-Romagna,156,17,3766,3939,25096,4469,33504,143,30116,3388,33504,597178,1025932,6114,2020-09-13
Veneto,95,14,2858,2967,19700,2142,24809,142,20314,4495,24809,671902,1711508,8090,2020-09-13
Lazio,424,17,4314,4755,7483,885,13123,143,7086,6037,13123,598963,720433,9580,2020-09-13
Toscana,80,17,2362,2459,9506,1149,13114,91,11112,2002,13114,424101,630201,6737,2020-09-13
Liguria,115,11,1017,1143,9130,1579,11852,78,9014,2838,11852,143543,266435,1682,2020-09-13
Campania,271,19,3651,3941,4733,451,9125,122,7839,1286,9125,304705,498723,4236,2020-09-13
Marche,14,2,504,520,6041,989,7550,39,7550,0,7550,132323,224119,1662,2020-09-13
Puglia,195,9,1474,1678,4201,570,6449,82,2148,4301,6449,250467,349719,2955,2020-09-13
PA Trento,9,0,433,442,4654,405,5501,9,3600,1901,5501,89234,204287,1166,2020-09-13
Sicilia,120,17,1656,1793,3158,290,5241,61,3556,1685,5241,300490,400678,2726,2020-09-13
Friuli Venezia Giulia,23,2,564,589,3219,349,4157,45,3907,250,4157,164825,360701,2138,2020-09-13
Abruzzo,41,3,535,579,2964,472,4015,37,3503,512,4015,113956,175854,1962,2020-09-13
PA Bolzano,8,0,288,296,2540,292,3128,40,3128,0,3128,79873,151122,1273,2020-09-13
Sardegna,80,14,1310,1404,1330,140,2874,33,1710,1164,2874,134443,158080,1252,2020-09-13
Umbria,19,4,415,438,1547,81,2066,24,1568,498,2066,107219,176517,1726,2020-09-13
Calabria,29,3,363,395,1222,98,1715,14,1159,556,1715,172919,175025,1315,2020-09-13
Valle d'Aosta,3,0,33,36,1078,146,1260,2,1129,131,1260,18539,26489,195,2020-09-13
Basilicata,5,1,150,156,429,28,613,3,414,199,613,62961,63771,360,2020-09-13
Molise,3,1,89,93,449,23,565,3,528,37,565,36107,37480,402,2020-09-13
Lombardia,251,27,8289,8567,77611,16896,103074,269,93050,10024,103074,1120531,1810149,16493,2020-09-12
Piemonte,104,9,1917,2030,27488,4153,33671,93,24034,9637,33671,388781,634323,3238,2020-09-12
Emilia-Romagna,152,17,3658,3827,25067,4469,33363,138,30044,3319,33363,592684,1019818,9911,2020-09-12
Veneto,99,12,2829,2940,19586,2141,24667,138,20273,4394,24667,668332,1703418,14390,2020-09-12
Toscana,74,18,2310,2402,9473,1148,13023,138,11095,1928,13023,419422,623464,6698,2020-09-12
Lazio,401,16,4204,4621,7475,884,12980,155,7050,5930,12980,590692,710853,10339,2020-09-12
Liguria,109,11,968,1088,9107,1579,11774,112,8984,2790,11774,142774,264753,2531,2020-09-12
Campania,254,17,3627,3898,4654,451,9003,103,7725,1278,9003,300981,494487,5427,2020-09-12
Marche,12,2,472,486,6036,989,7511,27,7511,0,7511,131401,222457,1843,2020-09-12
Puglia,189,8,1402,1599,4198,570,6367,76,2134,4233,6367,248777,346764,3764,2020-09-12
PA Trento,8,0,429,437,4650,405,5492,22,3597,1895,5492,88749,203121,1956,2020-09-12
Sicilia,116,18,1613,1747,3144,289,5180,44,3535,1645,5180,298359,397952,4002,2020-09-12
Friuli Venezia Giulia,18,2,566,586,3177,349,4112,39,3870,242,4112,163837,358563,2919,2020-09-12
Abruzzo,37,3,504,544,2962,472,3978,11,3468,510,3978,112658,173892,1584,2020-09-12
PA Bolzano,8,0,258,266,2530,292,3088,25,3088,0,3088,79095,149849,1542,2020-09-12
Sardegna,62,14,1303,1379,1322,140,2841,51,1698,1143,2841,133503,156828,1964,2020-09-12
Umbria,18,4,397,419,1542,81,2042,33,1564,478,2042,106482,174791,1410,2020-09-12
Calabria,28,3,357,388,1215,98,1701,18,1159,542,1701,171604,173710,1530,2020-09-12
Valle d'Aosta,3,0,31,34,1078,146,1258,1,1127,131,1258,18424,26294,106,2020-09-12
Basilicata,5,1,149,155,427,28,610,5,414,196,610,62601,63411,824,2020-09-12
Molise,3,0,87,90,449,23,562,3,526,36,562,35775,37078,235,2020-09-12
Lombardia,246,27,8318,8591,77318,16896,102805,257,92918,9887,102805,1110428,1793656,17986,2020-09-11
Piemonte,102,9,1849,1960,27465,4153,33578,57,24060,9518,33578,386993,631085,3268,2020-09-11
Emilia-Romagna,140,18,3572,3730,25027,4468,33225,152,29972,3253,33225,587767,1009907,10033,2020-09-11
Veneto,91,11,2862,2964,19427,2138,24529,173,20237,4292,24529,663769,1689028,15258,2020-09-11
Toscana,72,17,2223,2312,9425,1148,12885,147,11027,1858,12885,414906,616766,7575,2020-09-11
Lazio,365,14,4097,4476,7466,883,12825,148,7007,5818,12825,581864,700514,11621,2020-09-11
Liguria,96,12,886,994,9089,1579,11662,82,8914,2748,11662,141350,262222,2712,2020-09-11
Campania,239,13,3613,3865,4584,451,8900,140,7637,1263,8900,296120,489060,7293,2020-09-11
Marche,13,2,451,466,6029,989,7484,41,7484,0,7484,130636,220614,1508,2020-09-11
Puglia,188,8,1350,1546,4175,570,6291,82,2139,4152,6291,244885,343000,3554,2020-09-11
PA Trento,6,0,416,422,4643,405,5470,29,3588,1882,5470,88084,201165,1626,2020-09-11
Sicilia,112,17,1577,1706,3141,289,5136,104,3501,1635,5136,295881,393950,4212,2020-09-11
Friuli Venezia Giulia,17,3,542,562,3162,349,4073,34,3851,222,4073,162976,355644,3366,2020-09-11
Abruzzo,36,4,501,541,2954,472,3967,35,3467,500,3967,111700,172308,1685,2020-09-11
PA Bolzano,8,0,247,255,2516,292,3063,26,3063,0,3063,78315,148307,1009,2020-09-11
Sardegna,61,12,1264,1337,1314,139,2790,65,1677,1113,2790,131993,154864,2215,2020-09-11
Umbria,19,4,372,395,1533,81,2009,17,1559,450,2009,105483,173381,1318,2020-09-11
Calabria,28,3,339,370,1215,98,1683,8,1159,524,1683,170074,172180,1569,2020-09-11
Valle d'Aosta,2,0,31,33,1078,146,1257,3,1126,131,1257,18368,26188,60,2020-09-11
Basilicata,4,1,149,154,423,28,605,12,413,192,605,61777,62587,613,2020-09-11
Molise,4,0,84,88,448,23,559,4,523,36,559,35541,36843,399,2020-09-11
Lombardia,256,30,8166,8452,77204,16892,102548,245,92791,9757,102548,1098986,1775670,17391,2020-09-10
Piemonte,110,9,1799,1918,27450,4153,33521,74,24096,9425,33521,385183,627817,4532,2020-09-10
Emilia-Romagna,143,17,3451,3611,24994,4468,33073,110,29900,3173,33073,582928,999874,9161,2020-09-10
Veneto,83,12,2831,2926,19295,2135,24356,147,20166,4190,24356,658348,1673770,11419,2020-09-10
Toscana,74,13,2127,2214,9377,1147,12738,92,10971,1767,12738,409901,609191,7212,2020-09-10
Lazio,372,9,4001,4382,7413,882,12677,163,6968,5709,12677,571817,688893,10432,2020-09-10
Liguria,91,11,839,941,9060,1579,11580,114,8894,2686,11580,139851,259510,2966,2020-09-10
Campania,232,10,3500,3742,4568,450,8760,180,7540,1220,8760,289379,481767,7482,2020-09-10
Marche,11,2,426,439,6015,989,7443,40,7443,0,7443,129830,219106,1641,2020-09-10
Puglia,179,8,1283,1470,4169,570,6209,70,2126,4083,6209,242098,339446,3916,2020-09-10
PA Trento,6,0,392,398,4638,405,5441,82,3580,1861,5441,87467,199539,1894,2020-09-10
Sicilia,108,18,1477,1603,3140,289,5032,106,3457,1575,5032,293401,389738,4607,2020-09-10
Friuli Venezia Giulia,17,3,526,546,3144,349,4039,39,3827,212,4039,161912,352278,2283,2020-09-10
Abruzzo,35,3,474,512,2948,472,3932,11,3433,499,3932,110567,170623,1600,2020-09-10
PA Bolzano,8,0,231,239,2506,292,3037,20,3037,0,3037,77764,147298,1100,2020-09-10
Sardegna,57,12,1217,1286,1300,139,2725,63,1658,1067,2725,130074,152649,1971,2020-09-10
Umbria,16,3,371,390,1521,81,1992,24,1549,443,1992,104824,172063,1904,2020-09-10
Calabria,28,3,339,370,1207,98,1675,8,1159,516,1675,168505,170611,1395,2020-09-10
Valle d'Aosta,2,0,29,31,1077,146,1254,0,1123,131,1254,18332,26128,158,2020-09-10
Basilicata,4,1,138,143,422,28,593,6,413,180,593,61164,61974,664,2020-09-10
Molise,4,0,91,95,437,23,555,3,520,35,555,35157,36444,458,2020-09-10
Lombardia,252,27,8045,8324,77088,16891,102303,218,92681,9622,102303,1087646,1758279,21368,2020-09-09
Piemonte,100,9,1755,1864,27431,4152,33447,112,24122,9325,33447,383250,623285,4575,2020-09-09
Emilia-Romagna,140,16,3398,3554,24942,4467,32963,110,29855,3108,32963,578121,990713,10081,2020-09-09
Veneto,83,12,2842,2937,19137,2135,24209,91,20140,4069,24209,653982,1662351,10800,2020-09-09
Toscana,69,11,2061,2141,9358,1147,12646,88,10939,1707,12646,404903,601979,7137,2020-09-09
Lazio,358,9,3903,4270,7363,881,12514,175,6943,5571,12514,563118,678461,9171,2020-09-09
Liguria,87,11,809,907,8980,1579,11466,51,8814,2652,11466,138436,256544,2351,2020-09-09
Campania,226,10,3358,3594,4537,449,8580,203,7416,1164,8580,283355,474285,7154,2020-09-09
Marche,14,2,394,410,6005,988,7403,19,7403,0,7403,129006,217465,1503,2020-09-09
Puglia,172,6,1236,1414,4158,567,6139,97,2116,4023,6139,239744,335530,3611,2020-09-09
PA Trento,7,0,313,320,4634,405,5359,7,3543,1816,5359,86802,197645,1251,2020-09-09
Sicilia,105,15,1407,1527,3110,289,4926,77,3416,1510,4926,290674,385131,4783,2020-09-09
Friuli Venezia Giulia,17,3,491,511,3140,349,4000,54,3797,203,4000,161026,349995,3971,2020-09-09
Abruzzo,35,2,469,506,2943,472,3921,5,3427,494,3921,109697,169023,1545,2020-09-09
PA Bolzano,8,0,215,223,2502,292,3017,10,3017,0,3017,77178,146198,825,2020-09-09
Sardegna,51,12,1170,1233,1291,138,2662,47,1644,1018,2662,128433,150678,1308,2020-09-09
Umbria,17,2,354,373,1514,81,1968,33,1545,423,1968,103775,170159,1830,2020-09-09
Calabria,27,2,333,362,1207,98,1667,19,1159,508,1667,167110,169216,1478,2020-09-09
Valle d'Aosta,2,0,32,34,1074,146,1254,0,1123,131,1254,18254,25970,112,2020-09-09
Basilicata,4,1,133,138,421,28,587,14,412,175,587,60500,61310,681,2020-09-09
Molise,4,0,88,92,437,23,552,4,517,35,552,34699,35986,455,2020-09-09
Lombardia,248,27,7946,8221,76976,16888,102085,271,92597,9488,102085,1073431,1736911,20781,2020-09-08
Piemonte,104,9,1656,1769,27414,4152,33335,42,24139,9196,33335,380476,618710,3948,2020-09-08
Emilia-Romagna,130,16,3386,3532,24857,4465,32854,94,29809,3045,32854,572945,980632,12486,2020-09-08
Veneto,93,12,2809,2914,19072,2132,24118,105,20121,3997,24118,649669,1651551,9504,2020-09-08
Toscana,74,9,1996,2079,9334,1145,12558,59,10918,1640,12558,399495,594842,5824,2020-09-08
Lazio,354,9,3761,4124,7334,881,12339,129,6909,5430,12339,554654,669290,9363,2020-09-08
Liguria,85,11,764,860,8977,1578,11415,64,8812,2603,11415,137135,254193,2582,2020-09-08
Campania,220,9,3186,3415,4514,448,8377,249,7259,1118,8377,277421,467131,7991,2020-09-08
Marche,16,1,380,397,5999,988,7384,15,7384,0,7384,128178,215962,1216,2020-09-08
Puglia,163,7,1151,1321,4154,567,6042,143,2097,3945,6042,236175,331919,3590,2020-09-08
PA Trento,6,0,311,317,4630,405,5352,3,3539,1813,5352,86431,196394,593,2020-09-08
Sicilia,104,13,1337,1454,3106,289,4849,84,3389,1460,4849,287589,380348,5214,2020-09-08
Friuli Venezia Giulia,18,4,451,473,3124,349,3946,12,3760,186,3946,159635,346024,1648,2020-09-08
Abruzzo,34,2,487,523,2924,472,3919,14,3434,485,3919,108691,167478,867,2020-09-08
PA Bolzano,8,0,210,218,2497,292,3007,4,3007,0,3007,76699,145373,892,2020-09-08
Sardegna,48,10,1135,1193,1286,136,2615,51,1633,982,2615,127300,149370,1352,2020-09-08
Umbria,15,2,354,371,1483,81,1935,7,1538,397,1935,102837,168329,2336,2020-09-08
Calabria,29,1,326,356,1194,98,1648,8,1159,489,1648,165632,167738,1168,2020-09-08
Valle d'Aosta,2,0,37,39,1069,146,1254,5,1123,131,1254,18188,25858,134,2020-09-08
Basilicata,4,1,120,125,420,28,573,8,411,162,573,59819,60629,759,2020-09-08
Molise,5,0,83,88,437,23,548,3,517,31,548,34263,35531,155,2020-09-08
Lombardia,242,26,7842,8110,76818,16886,101814,109,92479,9335,101814,1059954,1716130,9088,2020-09-07
Piemonte,105,8,1639,1752,27390,4151,33293,37,24175,9118,33293,378191,614762,2550,2020-09-07
Emilia-Romagna,119,18,3356,3493,24803,4464,32760,132,29765,2995,32760,568812,968146,5403,2020-09-07
Veneto,85,13,2845,2943,18940,2130,24013,69,20109,3904,24013,645256,1642047,5089,2020-09-07
Toscana,77,9,1984,2070,9285,1144,12499,85,10896,1603,12499,395285,589018,5095,2020-09-07
Lazio,359,9,3667,4035,7294,881,12210,159,6890,5320,12210,545694,659927,9232,2020-09-07
Liguria,67,10,746,823,8951,1577,11351,59,8838,2513,11351,135646,251611,744,2020-09-07
Campania,223,7,2960,3190,4490,448,8128,218,7074,1054,8128,271727,459140,4262,2020-09-07
Marche,16,1,370,387,5994,988,7369,6,7369,0,7369,127431,214746,636,2020-09-07
Puglia,167,6,1024,1197,4137,565,5899,43,2083,3816,5899,233159,328329,1649,2020-09-07
PA Trento,5,0,310,315,4629,405,5349,17,3539,1810,5349,86198,195801,322,2020-09-07
Sicilia,101,13,1265,1379,3097,289,4765,49,3349,1416,4765,284332,375134,2333,2020-09-07
Friuli Venezia Giulia,16,4,442,462,3123,349,3934,11,3754,180,3934,159063,344376,1700,2020-09-07
Abruzzo,31,2,487,520,2914,472,3906,15,3424,482,3906,108107,166611,945,2020-09-07
PA Bolzano,8,2,205,215,2496,292,3003,0,3003,0,3003,76265,144481,800,2020-09-07
Sardegna,46,10,1086,1142,1286,136,2564,59,1628,936,2564,126031,148018,1155,2020-09-07
Umbria,15,2,349,366,1481,81,1928,13,1537,391,1928,101836,165993,535,2020-09-07
Calabria,29,1,325,355,1187,98,1640,17,1159,481,1640,164464,166570,620,2020-09-07
Valle d'Aosta,1,0,33,34,1069,146,1249,0,1119,130,1249,18111,25724,146,2020-09-07
Basilicata,4,1,114,119,418,28,565,1,411,154,565,59060,59870,72,2020-09-07
Molise,3,0,83,86,436,23,545,9,514,31,545,34109,35376,177,2020-09-07
Lombardia,248,25,7758,8031,76794,16880,101705,198,92417,9288,101705,1053199,1707042,12117,2020-09-06
Piemonte,111,8,1608,1727,27379,4150,33256,56,24235,9021,33256,376721,612212,2896,2020-09-06
Emilia-Romagna,124,14,3232,3370,24794,4464,32628,124,29703,2925,32628,563905,962743,10232,2020-09-06
Veneto,79,12,2848,2939,18875,2130,23944,179,20096,3848,23944,643251,1636958,9465,2020-09-06
Toscana,77,8,1909,1994,9277,1143,12414,122,10869,1545,12414,390411,583923,7803,2020-09-06
Lazio,355,10,3548,3913,7257,881,12051,122,6853,5198,12051,536609,650695,10786,2020-09-06
Liguria,62,9,697,768,8949,1575,11292,111,8824,2468,11292,135222,250867,1586,2020-09-06
Campania,221,7,2714,2942,4478,448,7868,100,6932,936,7868,268075,454878,5427,2020-09-06
Marche,14,1,370,385,5990,988,7363,20,7363,0,7363,127083,214110,1341,2020-09-06
Puglia,155,7,1005,1167,4126,563,5856,60,2070,3786,5856,231577,326680,3358,2020-09-06
PA Trento,5,0,293,298,4629,405,5332,33,3531,1801,5332,86002,195479,1438,2020-09-06
Sicilia,86,13,1235,1334,3093,289,4716,37,3330,1386,4716,282977,372801,2321,2020-09-06
Friuli Venezia Giulia,15,4,440,459,3115,349,3923,20,3743,180,3923,158395,342676,1283,2020-09-06
Abruzzo,32,2,475,509,2910,472,3891,26,3417,474,3891,107501,165666,1526,2020-09-06
PA Bolzano,8,2,208,218,2493,292,3003,7,3003,0,3003,75898,143681,554,2020-09-06
Sardegna,45,8,1032,1085,1284,136,2505,19,1617,888,2505,124985,146863,1175,2020-09-06
Umbria,13,2,341,356,1478,81,1915,25,1536,379,1915,101440,165458,1250,2020-09-06
Calabria,25,0,324,349,1176,98,1623,27,1159,464,1623,163844,165950,1508,2020-09-06
Valle d'Aosta,1,0,33,34,1069,146,1249,0,1119,130,1249,18011,25578,86,2020-09-06
Basilicata,4,1,118,123,413,28,564,9,411,153,564,58988,59798,444,2020-09-06
Molise,3,0,74,77,436,23,536,2,505,31,536,33934,35199,260,2020-09-06
Lombardia,245,23,7654,7922,76708,16877,101507,388,92304,9203,101507,1044945,1694925,23409,2020-09-05
Piemonte,106,7,1572,1685,27365,4150,33200,54,24260,8940,33200,374263,609316,3505,2020-09-05
Emilia-Romagna,122,12,3117,3251,24790,4464,32505,134,29640,2865,32505,556876,952511,10066,2020-09-05
Veneto,79,9,2789,2877,18758,2130,23765,188,20083,3682,23765,639941,1627493,15940,2020-09-05
Toscana,69,8,1812,1889,9260,1143,12292,113,10824,1468,12292,383856,576120,8354,2020-09-05
Lazio,344,11,3452,3807,7242,880,11929,158,6828,5101,11929,526843,639909,11740,2020-09-05
Liguria,54,7,646,707,8901,1573,11181,95,8761,2420,11181,134393,249281,2697,2020-09-05
Campania,207,6,2631,2844,4476,448,7768,119,6837,931,7768,263202,449451,6841,2020-09-05
Marche,13,1,355,369,5986,988,7343,32,7343,0,7343,126276,212769,1639,2020-09-05
Puglia,148,7,967,1122,4112,562,5796,55,2062,3734,5796,230046,323322,3163,2020-09-05
PA Trento,6,0,270,276,4618,405,5299,53,3505,1794,5299,85463,194041,1708,2020-09-05
Sicilia,88,12,1243,1343,3047,289,4679,114,3314,1365,4679,281041,370480,5273,2020-09-05
Friuli Venezia Giulia,15,3,427,445,3109,349,3903,49,3728,175,3903,157947,341393,2786,2020-09-05
Abruzzo,32,2,449,483,2910,472,3865,13,3396,469,3865,106544,164140,1657,2020-09-05
PA Bolzano,8,2,208,218,2486,292,2996,23,2996,0,2996,75681,143127,1480,2020-09-05
Sardegna,44,8,1018,1070,1280,136,2486,65,1613,873,2486,123894,145688,2395,2020-09-05
Umbria,13,2,322,337,1472,81,1890,16,1535,355,1890,100626,164208,1968,2020-09-05
Calabria,20,0,305,325,1173,98,1596,19,1159,437,1596,162336,164442,1954,2020-09-05
Valle d'Aosta,1,0,33,34,1069,146,1249,0,1119,130,1249,17954,25492,75,2020-09-05
Basilicata,3,1,111,115,412,28,555,7,410,145,555,58544,59354,664,2020-09-05
Molise,3,0,72,75,436,23,534,0,503,31,534,33674,34939,344,2020-09-05
Lombardia,244,26,7399,7669,76574,16876,101119,337,92117,9002,101119,1028404,1671516,27324,2020-09-04
Piemonte,110,7,1531,1648,27349,4149,33146,82,24291,8855,33146,372210,605811,4443,2020-09-04
Emilia-Romagna,114,13,3062,3189,24719,4463,32371,126,29578,2793,32371,551727,942445,10010,2020-09-04
Veneto,79,10,2691,2780,18671,2126,23577,273,20066,3511,23577,634616,1611553,19514,2020-09-04
Toscana,67,8,1742,1817,9219,1143,12179,99,10796,1383,12179,377468,567766,7730,2020-09-04
Lazio,363,9,3316,3688,7204,879,11771,171,6805,4966,11771,517073,628169,11744,2020-09-04
Liguria,48,6,619,673,8841,1572,11086,47,8699,2387,11086,132733,246584,2169,2020-09-04
Campania,196,5,2530,2731,4471,447,7649,171,6747,902,7649,257337,442610,6211,2020-09-04
Marche,12,1,328,341,5982,988,7311,17,7311,0,7311,125411,211130,1538,2020-09-04
Puglia,150,7,929,1086,4095,560,5741,117,2050,3691,5741,226927,320159,3319,2020-09-04
PA Trento,7,0,223,230,4611,405,5246,23,3490,1756,5246,84881,192333,1925,2020-09-04
Sicilia,87,11,1186,1284,2993,288,4565,78,3263,1302,4565,277515,365207,4241,2020-09-04
Friuli Venezia Giulia,11,4,397,412,3093,349,3854,23,3689,165,3854,156816,338607,3444,2020-09-04
Abruzzo,32,1,438,471,2910,472,3853,25,3391,462,3853,105546,162483,1503,2020-09-04
PA Bolzano,8,2,199,209,2472,292,2973,11,2973,0,2973,74949,141647,937,2020-09-04
Sardegna,41,6,963,1010,1276,135,2421,66,1601,820,2421,121848,143293,2252,2020-09-04
Umbria,11,3,313,327,1467,80,1874,35,1529,345,1874,99741,162240,2176,2020-09-04
Calabria,19,1,293,313,1167,97,1577,19,1159,418,1577,160382,162488,1684,2020-09-04
Valle d'Aosta,2,0,33,35,1068,146,1249,2,1119,130,1249,17904,25417,76,2020-09-04
Basilicata,3,1,104,108,412,28,548,7,410,138,548,57880,58690,640,2020-09-04
Molise,3,0,75,78,433,23,534,4,503,31,534,33340,34595,205,2020-09-04
Lombardia,225,27,7193,7445,76467,16870,100782,228,91957,8825,100782,1008369,1644192,14077,2020-09-03
Piemonte,92,7,1487,1586,27330,4148,33064,75,24308,8756,33064,369467,601368,4200,2020-09-03
Emilia-Romagna,108,11,3066,3185,24598,4463,32246,118,29507,2739,32246,546180,932435,10243,2020-09-03
Veneto,71,12,2531,2614,18567,2123,23304,115,20028,3276,23304,627148,1592039,13437,2020-09-03
Toscana,63,7,1661,1731,9206,1143,12080,113,10771,1309,12080,371628,560036,7960,2020-09-03
Lazio,351,9,3184,3544,7177,879,11600,154,6769,4831,11600,506670,616425,11329,2020-09-03
Liguria,39,7,581,627,8840,1572,11039,22,8666,2373,11039,131659,244415,2614,2020-09-03
Campania,185,4,2391,2580,4452,446,7478,193,6595,883,7478,252337,436399,6167,2020-09-03
Marche,13,1,321,335,5971,988,7294,21,7294,0,7294,124694,209592,1765,2020-09-03
Puglia,148,6,832,986,4078,560,5624,78,2029,3595,5624,224094,316840,3886,2020-09-03
PA Trento,3,1,206,210,4608,405,5223,91,3477,1746,5223,84365,190408,2317,2020-09-03
Sicilia,81,12,1159,1252,2947,288,4487,54,3235,1252,4487,275130,360966,3467,2020-09-03
Friuli Venezia Giulia,12,3,387,402,3080,349,3831,25,3675,156,3831,155933,335163,3048,2020-09-03
Abruzzo,33,1,420,454,2902,472,3828,24,3367,461,3828,104572,160980,1551,2020-09-03
PA Bolzano,8,2,196,206,2464,292,2962,4,2962,0,2962,74513,140710,1022,2020-09-03
Sardegna,35,6,905,946,1274,135,2355,39,1595,760,2355,120029,141041,1768,2020-09-03
Umbria,10,2,290,302,1457,80,1839,9,1526,313,1839,98418,160064,1108,2020-09-03
Calabria,20,1,273,294,1167,97,1558,13,1159,399,1558,158698,160804,1630,2020-09-03
Valle d'Aosta,3,0,33,36,1065,146,1247,4,1119,128,1247,17863,25341,132,2020-09-03
Basilicata,2,1,102,105,408,28,541,15,409,132,541,57240,58050,726,2020-09-03
Molise,3,0,72,75,432,23,530,2,502,28,530,33143,34390,343,2020-09-03
Lombardia,220,22,7036,7278,76407,16869,100554,237,91845,8709,100554,998868,1630115,17082,2020-09-02
Piemonte,90,7,1424,1521,27321,4147,32989,66,24332,8657,32989,366797,597168,5263,2020-09-02
Emilia-Romagna,104,10,2989,3103,24562,4463,32128,107,29457,2671,32128,540012,922192,11695,2020-09-02
Veneto,70,9,2477,2556,18510,2123,23189,163,20015,3174,23189,622175,1578602,17809,2020-09-02
Toscana,58,8,1570,1636,9189,1142,11967,69,10743,1224,11967,365415,552076,7629,2020-09-02
Lazio,343,9,3055,3407,7161,878,11446,130,6737,4709,11446,495791,605096,10544,2020-09-02
Liguria,38,6,563,607,8839,1571,11017,47,8682,2335,11017,130214,241801,2678,2020-09-02
Campania,163,4,2235,2402,4437,446,7285,117,6470,815,7285,247341,430232,5134,2020-09-02
Marche,14,1,305,320,5966,987,7273,17,7273,0,7273,123648,207827,1257,2020-09-02
Puglia,140,6,776,922,4067,557,5546,67,2017,3529,5546,221391,312954,4283,2020-09-02
PA Trento,4,1,118,123,4604,405,5132,33,3460,1672,5132,83762,188091,803,2020-09-02
Sicilia,76,12,1139,1227,2919,287,4433,83,3208,1225,4433,272775,357499,5627,2020-09-02
Friuli Venezia Giulia,11,3,373,387,3070,349,3806,20,3660,146,3806,154882,332115,3301,2020-09-02
Abruzzo,30,1,399,430,2902,472,3804,24,3353,451,3804,103603,159429,1548,2020-09-02
PA Bolzano,8,2,196,206,2460,292,2958,10,2958,0,2958,74019,139688,1048,2020-09-02
Sardegna,32,5,872,909,1272,135,2316,73,1588,728,2316,118433,139273,1907,2020-09-02
Umbria,8,2,288,298,1452,80,1830,27,1523,307,1830,97623,158956,2534,2020-09-02
Calabria,21,0,269,290,1158,97,1545,32,1159,386,1545,157068,159174,1772,2020-09-02
Valle d'Aosta,3,0,29,32,1065,146,1243,2,1117,126,1243,17785,25209,152,2020-09-02
Molise,3,0,70,73,432,23,528,0,502,26,528,32812,34047,308,2020-09-02
Basilicata,1,1,88,90,408,28,526,2,405,121,526,56534,57324,585,2020-09-02
Lombardia,212,21,6849,7082,76368,16867,100317,242,91748,8569,100317,986403,1613033,16200,2020-09-01
Piemonte,92,7,1365,1464,27313,4146,32923,42,24382,8541,32923,363196,591905,3997,2020-09-01
Emilia-Romagna,106,9,2946,3061,24497,4463,32021,99,29408,2613,32021,533273,910497,10764,2020-09-01
Veneto,69,9,2382,2460,18444,2122,23026,97,19989,3037,23026,614376,1560793,6598,2020-09-01
Toscana,53,9,1519,1581,9175,1142,11898,40,10726,1172,11898,360022,544447,4929,2020-09-01
Lazio,336,8,2941,3285,7153,878,11316,125,6711,4605,11316,486744,594552,10070,2020-09-01
Liguria,39,5,516,560,8839,1571,10970,19,8644,2326,10970,128951,239123,1721,2020-09-01
Marche,14,1,294,309,5960,987,7256,16,7256,0,7256,122724,206570,1762,2020-09-01
Campania,143,6,2143,2292,4430,446,7168,102,6392,776,7168,242683,425098,5837,2020-09-01
Puglia,123,7,730,860,4062,557,5479,39,2015,3464,5479,218643,308671,3651,2020-09-01
PA Trento,4,1,87,92,4602,405,5099,3,3450,1649,5099,83419,187288,695,2020-09-01
Sicilia,71,10,1071,1152,2911,287,4350,33,3176,1174,4350,269806,351872,4210,2020-09-01
Friuli Venezia Giulia,12,2,363,377,3061,348,3786,17,3647,139,3786,153624,328814,2822,2020-09-01
Abruzzo,29,1,376,406,2902,472,3780,5,3331,449,3780,102588,157881,846,2020-09-01
PA Bolzano,8,2,191,201,2455,292,2948,13,2948,0,2948,73432,138640,619,2020-09-01
Sardegna,31,6,800,837,1272,134,2243,50,1580,663,2243,116718,137366,1749,2020-09-01
Umbria,9,2,267,278,1445,80,1803,10,1518,285,1803,96713,156422,2251,2020-09-01
Calabria,22,0,244,266,1150,97,1513,22,1159,354,1513,155296,157402,1557,2020-09-01
Valle d'Aosta,3,0,27,30,1065,146,1241,0,1115,126,1241,17699,25057,164,2020-09-01
Molise,3,0,70,73,432,23,528,3,502,26,528,32507,33739,146,2020-09-01
Basilicata,1,1,86,88,408,28,524,1,405,119,524,55949,56739,462,2020-09-01
Lombardia,195,22,6735,6952,76258,16865,100075,135,91637,8438,100075,974484,1596833,9866,2020-08-31
Piemonte,98,7,1327,1432,27303,4146,32881,37,24398,8483,32881,360988,587908,2077,2020-08-31
Emilia-Romagna,106,9,2862,2977,24482,4463,31922,117,29354,2568,31922,528294,899733,6132,2020-08-31
Veneto,51,8,2328,2387,18422,2120,22929,65,19971,2958,22929,611002,1554195,6657,2020-08-31
Toscana,52,8,1514,1574,9143,1141,11858,73,10715,1143,11858,356542,539518,4438,2020-08-31
Lazio,328,7,2839,3174,7139,878,11191,148,6686,4505,11191,477920,584482,13093,2020-08-31
Liguria,38,1,502,541,8839,1571,10951,44,8693,2258,10951,128050,237402,1360,2020-08-31
Marche,13,1,284,298,5955,987,7240,2,7240,0,7240,121684,204808,719,2020-08-31
Campania,95,1,2114,2210,4411,445,7066,184,6341,725,7066,237519,419261,5783,2020-08-31
Puglia,116,7,721,844,4040,556,5440,38,2008,3432,5440,216105,305020,1974,2020-08-31
PA Trento,5,1,85,91,4600,405,5096,4,3448,1648,5096,83022,186593,112,2020-08-31
Sicilia,70,10,1045,1125,2906,286,4317,26,3162,1155,4317,267086,347662,1315,2020-08-31
Abruzzo,35,1,391,427,2878,472,3777,4,3331,446,3777,101993,157035,261,2020-08-31
Friuli Venezia Giulia,13,2,350,365,3056,348,3769,5,3640,129,3769,152510,325992,717,2020-08-31
PA Bolzano,8,2,180,190,2453,292,2935,3,2935,0,2935,73091,138021,904,2020-08-31
Sardegna,28,4,757,789,1270,134,2193,79,1574,619,2193,115112,135617,1083,2020-08-31
Umbria,10,2,256,268,1445,80,1793,9,1518,275,1793,95705,154171,505,2020-08-31
Calabria,21,0,224,245,1149,97,1491,14,1159,332,1491,153811,155845,926,2020-08-31
Valle d'Aosta,2,0,29,31,1064,146,1241,9,1115,126,1241,17602,24893,110,2020-08-31
Molise,3,0,67,70,432,23,525,0,502,23,525,32364,33593,210,2020-08-31
Basilicata,1,1,86,88,408,28,524,0,405,119,524,55487,56277,276,2020-08-31
Lombardia,194,20,6615,6829,76248,16863,99940,235,91582,8358,99940,966973,1586967,12863,2020-08-30
Piemonte,85,5,1315,1405,27293,4146,32844,60,24400,8444,32844,359814,585831,3045,2020-08-30
Emilia-Romagna,99,11,2758,2868,24478,4459,31805,109,29294,2511,31805,524656,893601,9202,2020-08-30
Veneto,52,7,2286,2345,18399,2120,22864,109,19964,2900,22864,607977,1547538,7185,2020-08-30
Toscana,48,5,1450,1503,9141,1141,11785,98,10695,1090,11785,353231,535080,6433,2020-08-30
Lazio,310,7,2718,3035,7130,878,11043,156,6686,4357,11043,466475,571389,12784,2020-08-30
Liguria,32,1,476,509,8827,1571,10907,53,8670,2237,10907,127057,236042,1756,2020-08-30
Marche,12,1,289,302,5949,987,7238,15,7238,0,7238,121344,204089,1421,2020-08-30
Campania,110,4,1911,2025,4412,445,6882,270,6243,639,6882,233301,413478,6729,2020-08-30
Puglia,117,5,695,817,4029,556,5402,69,2004,3398,5402,213959,303046,2708,2020-08-30
PA Trento,3,1,83,87,4600,405,5092,8,3445,1647,5092,82952,186481,1053,2020-08-30
Sicilia,68,10,1036,1114,2891,286,4291,34,3152,1139,4291,266061,346347,2365,2020-08-30
Abruzzo,37,1,391,429,2872,472,3773,34,3331,442,3773,101829,156774,2184,2020-08-30
Friuli Venezia Giulia,15,1,344,360,3056,348,3764,16,3636,128,3764,152158,325275,1435,2020-08-30
PA Bolzano,8,2,180,190,2450,292,2932,8,2932,0,2932,72684,137117,973,2020-08-30
Sardegna,28,3,681,712,1268,134,2114,22,1563,551,2114,114114,134534,1134,2020-08-30
Umbria,10,1,251,262,1442,80,1784,31,1518,266,1784,95419,153666,1662,2020-08-30
Calabria,17,0,215,232,1148,97,1477,34,1159,318,1477,152885,154919,1379,2020-08-30
Valle d'Aosta,2,0,21,23,1063,146,1232,2,1108,124,1232,17533,24783,105,2020-08-30
Molise,3,0,67,70,432,23,525,1,502,23,525,32155,33383,306,2020-08-30
Basilicata,1,1,86,88,408,28,524,1,405,119,524,55211,56001,1,2020-08-30
Lombardia,185,18,6442,6645,76200,16860,99705,289,91476,8229,99705,957455,1574104,18701,2020-08-29
Piemonte,81,5,1297,1383,27256,4145,32784,90,24402,8382,32784,357323,582786,3752,2020-08-29
Emilia-Romagna,98,10,2661,2769,24468,4459,31696,149,29241,2455,31696,519748,884399,10087,2020-08-29
Veneto,54,6,2285,2345,18290,2120,22755,151,19956,2799,22755,604918,1540353,17451,2020-08-29
Toscana,44,5,1372,1421,9125,1141,11687,92,10650,1037,11687,348617,528647,6701,2020-08-29
Lazio,293,8,2581,2882,7127,878,10887,171,6643,4244,10887,455146,558605,13010,2020-08-29
Liguria,29,1,463,493,8790,1571,10854,47,8644,2210,10854,126071,234286,1936,2020-08-29
Marche,10,1,285,296,5940,987,7223,12,7223,0,7223,120551,202668,1791,2020-08-29
Campania,72,2,1697,1771,4396,445,6612,188,6098,514,6612,227878,406749,4359,2020-08-29
Puglia,112,5,631,748,4029,556,5333,65,1981,3352,5333,212037,300338,2753,2020-08-29
PA Trento,3,1,80,84,4595,405,5084,14,3441,1643,5084,82538,185428,1365,2020-08-29
Sicilia,70,10,1004,1084,2887,286,4257,29,3137,1120,4257,264227,343982,2872,2020-08-29
Friuli Venezia Giulia,15,0,333,348,3052,348,3748,20,3627,121,3748,151497,323840,5132,2020-08-29
Abruzzo,37,1,357,395,2872,472,3739,14,3309,430,3739,100339,154590,1457,2020-08-29
PA Bolzano,8,2,180,190,2442,292,2924,9,2924,0,2924,72200,136144,1427,2020-08-29
Sardegna,24,2,665,691,1267,134,2092,70,1560,532,2092,113122,133400,1796,2020-08-29
Umbria,11,1,226,238,1435,80,1753,12,1516,237,1753,94548,152004,2088,2020-08-29
Calabria,17,0,181,198,1148,97,1443,11,1159,284,1443,151506,153540,1530,2020-08-29
Valle d'Aosta,1,0,18,19,1065,146,1230,4,1108,122,1230,17463,24678,50,2020-08-29
Molise,3,0,66,69,432,23,524,2,502,22,524,31853,33077,158,2020-08-29
Basilicata,1,1,85,87,408,28,523,5,405,118,523,55210,56000,692,2020-08-29
Lombardia,172,17,6265,6454,76102,16860,99416,316,91355,8061,99416,943463,1555403,19721,2020-08-28
Piemonte,82,6,1258,1346,27203,4145,32694,91,24420,8274,32694,354777,579034,4219,2020-08-28
Emilia-Romagna,94,9,2518,2621,24467,4459,31547,164,29170,2377,31547,513131,874312,10080,2020-08-28
Veneto,50,6,2197,2253,18232,2119,22604,135,19941,2663,22604,598349,1522902,14915,2020-08-28
Toscana,47,4,1298,1349,9105,1141,11595,82,10625,970,11595,343913,521946,6067,2020-08-28
Liguria,28,0,441,469,8767,1571,10807,46,8644,2163,10807,125061,232350,2038,2020-08-28
Lazio,283,6,2427,2716,7122,878,10716,166,6611,4105,10716,444539,545595,14013,2020-08-28
Marche,8,1,282,291,5933,987,7211,17,7211,0,7211,119608,200877,1529,2020-08-28
Campania,121,5,1470,1596,4383,445,6424,183,5990,434,6424,224127,402390,5494,2020-08-28
Puglia,104,5,575,684,4028,556,5268,51,1964,3304,5268,209467,297585,3159,2020-08-28
PA Trento,6,1,67,74,4591,405,5070,16,3433,1637,5070,82117,184063,1390,2020-08-28
Sicilia,69,9,980,1058,2884,286,4228,54,3125,1103,4228,261940,341110,3236,2020-08-28
Friuli Venezia Giulia,13,0,334,347,3033,348,3728,19,3607,121,3728,149961,318708,2230,2020-08-28
Abruzzo,39,1,343,383,2870,472,3725,20,3300,425,3725,99372,153133,1410,2020-08-28
PA Bolzano,8,1,180,189,2434,292,2915,8,2915,0,2915,71480,134717,1281,2020-08-28
Sardegna,23,2,597,622,1266,134,2022,55,1555,467,2022,111549,131604,1552,2020-08-28
Umbria,12,0,217,229,1432,80,1741,22,1515,226,1741,93480,149916,2021,2020-08-28
Calabria,14,0,175,189,1146,97,1432,10,1159,273,1432,149976,152010,1538,2020-08-28
Valle d'Aosta,1,0,14,15,1065,146,1226,2,1106,120,1226,17429,24628,90,2020-08-28
Molise,3,0,64,67,432,23,522,1,502,20,522,31696,32919,469,2020-08-28
Basilicata,1,1,81,83,407,28,518,4,405,113,518,54518,55308,613,2020-08-28
Lombardia,173,14,6038,6225,76018,16857,99100,286,91221,7879,99100,929040,1535682,17964,2020-08-27
Piemonte,78,6,1197,1281,27178,4144,32603,88,24453,8150,32603,351842,574815,4902,2020-08-27
Emilia-Romagna,93,8,2366,2467,24460,4458,31385,171,29098,2287,31385,506243,864232,10322,2020-08-27
Veneto,58,5,2158,2221,18131,2117,22469,132,19921,2548,22469,593488,1507987,15577,2020-08-27
Toscana,43,5,1225,1273,9100,1140,11513,99,10608,905,11513,339644,515879,6154,2020-08-27
Liguria,26,0,432,458,8732,1571,10761,37,8664,2097,10761,123950,230312,2213,2020-08-27
Lazio,268,6,2281,2555,7118,877,10550,152,6576,3974,10550,431825,531582,10590,2020-08-27
Marche,8,0,275,283,5924,987,7194,61,7194,0,7194,118825,199348,2169,2020-08-27
Campania,108,4,1311,1423,4373,445,6241,130,5888,353,6241,219960,396896,3631,2020-08-27
Puglia,97,3,537,637,4024,556,5217,47,1957,3260,5217,207094,294426,3161,2020-08-27
PA Trento,4,1,56,61,4588,405,5054,15,3421,1633,5054,81734,182673,1351,2020-08-27
Sicilia,62,10,947,1019,2869,286,4174,50,3102,1072,4174,259530,337874,4072,2020-08-27
Friuli Venezia Giulia,13,0,322,335,3026,348,3709,25,3599,110,3709,149088,316478,3503,2020-08-27
Abruzzo,37,1,343,381,2852,472,3705,18,3283,422,3705,98466,151723,1574,2020-08-27
PA Bolzano,8,1,176,185,2430,292,2907,9,2907,0,2907,70742,133436,898,2020-08-27
Sardegna,24,2,542,568,1265,134,1967,57,1548,419,1967,110167,130052,1629,2020-08-27
Umbria,12,1,209,222,1417,80,1719,20,1514,205,1719,92218,147895,1466,2020-08-27
Calabria,14,0,165,179,1146,97,1422,6,1159,263,1422,148438,150472,1604,2020-08-27
Valle d'Aosta,0,0,13,13,1065,146,1224,1,1105,119,1224,17385,24538,100,2020-08-27
Molise,3,0,63,66,432,23,521,1,502,19,521,31234,32450,590,2020-08-27
Basilicata,2,0,78,80,406,28,514,6,403,111,514,53905,54695,554,2020-08-27
Lombardia,158,17,5794,5969,75988,16857,98814,269,91103,7711,98814,915651,1517718,16561,2020-08-26
Piemonte,83,6,1119,1208,27163,4144,32515,75,24518,7997,32515,348648,569913,5545,2020-08-26
Emilia-Romagna,92,6,2203,2301,24455,4458,31214,120,29022,2192,31214,501373,853910,10757,2020-08-26
Veneto,46,6,2106,2158,18063,2116,22337,147,19902,2435,22337,588214,1492410,16102,2020-08-26
Toscana,43,6,1142,1191,9083,1140,11414,161,10595,819,11414,335476,509725,6084,2020-08-26
Liguria,23,0,417,440,8713,1571,10724,41,8683,2041,10724,122720,228099,2343,2020-08-26
Lazio,263,6,2143,2412,7110,876,10398,162,6554,3844,10398,424488,520992,9008,2020-08-26
Marche,9,0,232,241,5905,987,7133,9,7133,0,7133,117791,197179,1385,2020-08-26
Campania,75,3,1217,1295,4373,443,6111,135,5812,299,6111,216836,393265,3026,2020-08-26
Puglia,94,4,499,597,4018,555,5170,51,1940,3230,5170,204620,291265,3510,2020-08-26
PA Trento,4,1,42,47,4587,405,5039,7,3414,1625,5039,81224,181322,1898,2020-08-26
Sicilia,59,10,911,980,2858,286,4124,33,3077,1047,4124,256456,333802,3353,2020-08-26
Abruzzo,34,1,331,366,2849,472,3687,26,3273,414,3687,97421,150149,1248,2020-08-26
Friuli Venezia Giulia,14,0,307,321,3015,348,3684,33,3583,101,3684,147690,312975,5509,2020-08-26
PA Bolzano,8,1,169,178,2428,292,2898,5,2898,0,2898,70275,132538,1431,2020-08-26
Sardegna,20,1,492,513,1265,134,1912,53,1537,375,1912,108703,128423,1608,2020-08-26
Umbria,11,1,200,212,1407,80,1699,20,1512,187,1699,91421,146429,1840,2020-08-26
Calabria,14,0,159,173,1146,97,1416,8,1159,257,1416,146834,148868,1224,2020-08-26
Valle d'Aosta,0,0,12,12,1065,146,1223,0,1104,119,1223,17328,24438,208,2020-08-26
Molise,3,0,62,65,432,23,520,9,501,19,520,30659,31860,350,2020-08-26
Basilicata,2,0,72,74,406,28,508,3,403,105,508,53350,54141,539,2020-08-26
Lombardia,158,15,5614,5787,75901,16857,98545,119,90963,7582,98545,903586,1501157,9879,2020-08-25
Piemonte,79,6,1057,1142,27155,4143,32440,57,24548,7892,32440,344929,564368,3545,2020-08-25
Emilia-Romagna,90,5,2094,2189,24447,4458,31094,65,28969,2125,31094,496062,843153,11052,2020-08-25
Veneto,46,5,2068,2119,17964,2107,22190,119,19873,2317,22190,581727,1476308,13156,2020-08-25
Toscana,41,5,993,1039,9075,1139,11253,34,10574,679,11253,331202,503641,3874,2020-08-25
Liguria,24,0,389,413,8699,1571,10683,12,8662,2021,10683,121487,225756,1562,2020-08-25
Lazio,281,6,1997,2284,7077,875,10236,143,6530,3706,10236,417490,511984,9336,2020-08-25
Marche,14,0,234,248,5889,987,7124,11,7124,0,7124,117078,195794,1364,2020-08-25
Campania,76,3,1085,1164,4370,442,5976,138,5733,243,5976,214193,390239,3620,2020-08-25
Puglia,88,4,456,548,4016,555,5119,49,1921,3198,5119,202052,287755,3272,2020-08-25
PA Trento,4,1,42,47,4580,405,5032,3,3411,1621,5032,80672,179424,530,2020-08-25
Sicilia,53,10,884,947,2858,286,4091,24,3070,1021,4091,253585,330449,2634,2020-08-25
Abruzzo,33,1,308,342,2848,472,3662,10,3256,406,3662,96605,148901,752,2020-08-25
Friuli Venezia Giulia,13,2,283,298,3005,348,3651,9,3561,90,3651,145371,307466,1408,2020-08-25
PA Bolzano,8,1,168,177,2424,292,2893,9,2893,0,2893,69465,131107,590,2020-08-25
Sardegna,19,0,444,463,1262,134,1859,34,1533,326,1859,107288,126815,1584,2020-08-25
Umbria,12,1,182,195,1404,80,1679,29,1505,174,1679,90382,144589,2010,2020-08-25
Calabria,14,1,155,170,1141,97,1408,8,1159,249,1408,145610,147644,1458,2020-08-25
Valle d'Aosta,1,0,12,13,1064,146,1223,2,1104,119,1223,17211,24230,107,2020-08-25
Molise,2,0,54,56,432,23,511,0,500,11,511,30317,31510,106,2020-08-25
Basilicata,2,0,71,73,404,28,505,3,403,102,505,52812,53602,502,2020-08-25
Lombardia,153,15,5696,5864,75705,16857,98426,110,91020,7406,98426,896473,1491278,7722,2020-08-24
Piemonte,83,5,1007,1095,27145,4143,32383,40,24557,7826,32383,342897,560823,1904,2020-08-24
Emilia-Romagna,82,8,2049,2139,24434,4458,31031,116,28939,2092,31031,491660,832101,5019,2020-08-24
Veneto,43,4,2001,2048,17919,2104,22071,116,19852,2219,22071,575140,1463152,9468,2020-08-24
Toscana,39,5,971,1015,9065,1139,11219,44,10560,659,11219,328743,499767,3059,2020-08-24
Liguria,22,0,379,401,8699,1571,10671,26,8670,2001,10671,120593,224194,1039,2020-08-24
Lazio,299,6,1846,2151,7067,875,10093,146,6509,3584,10093,409290,502648,6000,2020-08-24
Marche,13,0,230,243,5883,987,7113,3,7113,0,7113,116228,194430,714,2020-08-24
Campania,72,2,967,1041,4356,441,5838,116,5636,202,5838,211095,386619,3132,2020-08-24
Puglia,81,4,420,505,4010,555,5070,45,1913,3157,5070,199575,284483,1068,2020-08-24
PA Trento,3,1,40,44,4580,405,5029,1,3409,1620,5029,80388,178894,147,2020-08-24
Sicilia,54,9,884,947,2834,286,4067,65,3063,1004,4067,251757,327815,1468,2020-08-24
Abruzzo,34,1,301,336,2844,472,3652,4,3251,401,3652,96085,148149,186,2020-08-24
Friuli Venezia Giulia,11,2,278,291,3003,348,3642,2,3554,88,3642,145196,306058,901,2020-08-24
PA Bolzano,8,1,163,172,2420,292,2884,15,2884,0,2884,69119,130517,609,2020-08-24
Sardegna,18,0,411,429,1262,134,1825,91,1531,294,1825,105849,125231,1094,2020-08-24
Umbria,12,1,157,170,1400,80,1650,11,1503,147,1650,89426,142579,632,2020-08-24
Calabria,13,1,153,167,1136,97,1400,2,1159,241,1400,144148,146186,1274,2020-08-24
Valle d'Aosta,1,0,10,11,1064,146,1221,0,1103,118,1221,17141,24123,41,2020-08-24
Molise,2,0,54,56,432,23,511,0,500,11,511,30213,31404,159,2020-08-24
Basilicata,2,0,68,70,404,28,502,0,402,100,502,52310,53100,278,2020-08-24
Lombardia,148,14,5620,5782,75678,16856,98316,239,90944,7372,98316,890586,1483556,13663,2020-08-23
Piemonte,78,5,978,1061,27139,4143,32343,42,24571,7772,32343,341447,558919,3325,2020-08-23
Emilia-Romagna,77,8,1949,2034,24425,4456,30915,127,28880,2035,30915,488330,827082,6430,2020-08-23
Veneto,43,4,1942,1989,17862,2104,21955,145,19837,2118,21955,569875,1453684,10592,2020-08-23
Toscana,35,7,938,980,9056,1139,11175,59,10537,638,11175,326623,496708,4129,2020-08-23
Liguria,18,1,379,398,8676,1571,10645,28,8670,1975,10645,119961,223155,1537,2020-08-23
Lazio,286,6,1735,2027,7046,874,9947,184,6468,3479,9947,404727,496648,8374,2020-08-23
Marche,12,1,232,245,5878,987,7110,5,7110,0,7110,115806,193716,1617,2020-08-23
Campania,61,2,862,925,4356,441,5722,138,5574,148,5722,208401,383487,4135,2020-08-23
PA Trento,3,1,39,43,4580,405,5028,3,3408,1620,5028,80296,178747,1062,2020-08-23
Puglia,68,4,395,467,4003,555,5025,33,1902,3123,5025,198019,283415,1591,2020-08-23
Sicilia,50,10,843,903,2813,286,4002,35,3060,942,4002,250646,326347,2146,2020-08-23
Abruzzo,31,1,300,332,2844,472,3648,21,3250,398,3648,95928,147963,1384,2020-08-23
Friuli Venezia Giulia,10,2,279,291,3001,348,3640,24,3552,88,3640,144651,305157,2565,2020-08-23
PA Bolzano,8,1,148,157,2420,292,2869,13,2869,0,2869,68769,129908,1055,2020-08-23
Sardegna,18,0,320,338,1262,134,1734,81,1515,219,1734,104930,124137,1081,2020-08-23
Umbria,11,1,148,160,1399,80,1639,19,1499,140,1639,88882,141947,1162,2020-08-23
Calabria,11,1,154,166,1135,97,1398,8,1159,239,1398,142878,144912,1184,2020-08-23
Valle d'Aosta,1,0,10,11,1064,146,1221,0,1103,118,1221,17117,24082,175,2020-08-23
Molise,1,0,57,58,430,23,511,1,500,11,511,30064,31245,159,2020-08-23
Basilicata,1,0,70,71,403,28,502,5,402,100,502,52032,52822,5,2020-08-23
Lombardia,148,14,5414,5576,75649,16852,98077,185,90802,7275,98077,880198,1469893,12957,2020-08-22
Piemonte,80,4,947,1031,27127,4143,32301,41,24599,7702,32301,338684,555594,3261,2020-08-22
Emilia-Romagna,75,8,1842,1925,24408,4455,30788,80,28821,1967,30788,483710,820652,9423,2020-08-22
Veneto,44,4,1944,1992,17714,2104,21810,160,19821,1989,21810,565251,1443092,13886,2020-08-22
Toscana,30,6,892,928,9049,1139,11116,53,10520,596,11116,323792,492579,4699,2020-08-22
Liguria,18,1,356,375,8671,1571,10617,34,8668,1949,10617,119030,221618,1848,2020-08-22
Lazio,265,6,1599,1870,7020,873,9763,215,6435,3328,9763,397550,488274,7792,2020-08-22
Marche,11,1,230,242,5876,987,7105,10,7105,0,7105,114764,192099,1658,2020-08-22
Campania,55,1,736,792,4352,440,5584,61,5455,129,5584,204634,379352,4269,2020-08-22
PA Trento,3,1,36,40,4580,405,5025,9,3406,1619,5025,79771,177685,2516,2020-08-22
Puglia,62,4,370,436,4001,555,4992,22,1887,3105,4992,196707,281824,2579,2020-08-22
Sicilia,45,8,821,874,2807,286,3967,48,3049,918,3967,249033,324201,2220,2020-08-22
Abruzzo,32,1,280,313,2843,472,3628,24,3237,391,3628,95034,146579,1210,2020-08-22
Friuli Venezia Giulia,9,2,261,272,2996,348,3616,33,3530,86,3616,143300,302592,3362,2020-08-22
PA Bolzano,8,1,137,146,2418,292,2856,19,2856,0,2856,68151,128853,1840,2020-08-22
Sardegna,14,0,243,257,1262,134,1653,44,1472,181,1653,104014,123056,760,2020-08-22
Umbria,12,1,129,142,1398,80,1620,18,1494,126,1620,88187,140785,1378,2020-08-22
Calabria,11,1,146,158,1135,97,1390,11,1159,231,1390,141694,143728,1342,2020-08-22
Valle d'Aosta,1,0,10,11,1064,146,1221,0,1103,118,1221,16988,23907,75,2020-08-22
Molise,1,0,56,57,430,23,510,1,499,11,510,29986,31086,200,2020-08-22
Basilicata,0,0,66,66,403,28,497,3,402,95,497,52027,52817,399,2020-08-22
Lombardia,149,17,5328,5494,75546,16852,97892,174,90669,7223,97892,871210,1456936,10703,2020-08-21
Piemonte,85,4,912,1001,27117,4142,32260,39,24617,7643,32260,336656,552333,3765,2020-08-21
Emilia-Romagna,77,8,1776,1861,24392,4455,30708,82,28787,1921,30708,478418,811229,10062,2020-08-21
Veneto,42,6,1817,1865,17683,2102,21650,116,19793,1857,21650,559317,1429206,12522,2020-08-21
Toscana,28,5,845,878,9046,1139,11063,79,10501,562,11063,320543,487880,4154,2020-08-21
Liguria,19,1,345,365,8647,1571,10583,21,8650,1933,10583,118087,219770,1794,2020-08-21
Lazio,248,6,1412,1666,7009,873,9548,137,6407,3141,9548,392577,480482,6584,2020-08-21
Marche,13,1,218,232,5876,987,7095,17,7095,0,7095,113688,190441,2086,2020-08-21
Campania,66,2,667,735,4348,440,5523,67,5394,129,5523,201641,375083,3475,2020-08-21
PA Trento,3,1,37,41,4570,405,5016,4,3405,1611,5016,79214,175169,745,2020-08-21
Puglia,61,4,354,419,3996,555,4970,35,1884,3086,4970,194436,279245,2931,2020-08-21
Sicilia,45,8,775,828,2805,286,3919,44,3034,885,3919,247547,321981,3129,2020-08-21
Abruzzo,30,1,258,289,2843,472,3604,23,3215,389,3604,94284,145369,1210,2020-08-21
Friuli Venezia Giulia,9,2,232,243,2992,348,3583,36,3503,80,3583,141840,299230,3158,2020-08-21
PA Bolzano,8,1,132,141,2404,292,2837,5,2837,0,2837,66986,127013,1290,2020-08-21
Sardegna,13,0,200,213,1262,134,1609,42,1436,173,1609,103362,122296,944,2020-08-21
Umbria,10,1,113,124,1398,80,1602,22,1491,111,1602,87468,139407,1356,2020-08-21
Calabria,11,1,141,153,1129,97,1379,2,1159,220,1379,140352,142386,1340,2020-08-21
Valle d'Aosta,1,0,10,11,1064,146,1221,0,1103,118,1221,16942,23832,79,2020-08-21
Molise,1,0,55,56,430,23,509,2,498,11,509,29696,30886,209,2020-08-21
Basilicata,0,0,63,63,403,28,494,0,402,92,494,51628,52418,460,2020-08-21
Lombardia,155,16,5252,5423,75449,16846,97718,154,90583,7135,97718,864187,1446233,13757,2020-08-20
Piemonte,83,3,891,977,27102,4142,32221,52,24645,7576,32221,334082,548568,4824,2020-08-20
Emilia-Romagna,77,8,1731,1816,24355,4455,30626,52,28749,1877,30626,473891,801167,11184,2020-08-20
Veneto,35,7,1747,1789,17645,2100,21534,159,19765,1769,21534,553065,1416684,13294,2020-08-20
Toscana,24,5,772,801,9044,1139,10984,59,10476,508,10984,317235,483726,4623,2020-08-20
Liguria,21,1,333,355,8636,1571,10562,31,8629,1933,10562,117149,217976,2361,2020-08-20
Lazio,238,6,1296,1540,6999,872,9411,115,6379,3032,9411,387285,473898,5579,2020-08-20
Marche,14,1,202,217,5874,987,7078,13,7078,0,7078,112396,188355,1579,2020-08-20
Campania,56,2,613,671,4345,440,5456,53,5327,129,5456,198778,371608,2381,2020-08-20
PA Trento,2,1,41,44,4563,405,5012,4,3404,1608,5012,78859,174424,1721,2020-08-20
Puglia,58,3,328,389,3991,555,4935,20,1876,3059,4935,192370,276314,2682,2020-08-20
Sicilia,41,8,741,790,2799,286,3875,37,3024,851,3875,245539,318852,2982,2020-08-20
Abruzzo,27,1,240,268,2841,472,3581,4,3206,375,3581,93423,144159,1118,2020-08-20
Friuli Venezia Giulia,9,3,210,222,2977,348,3547,14,3485,62,3547,140671,296072,3440,2020-08-20
PA Bolzano,8,1,130,139,2401,292,2832,21,2832,0,2832,66156,125723,1137,2020-08-20
Umbria,10,1,101,112,1388,80,1580,17,1488,92,1580,86741,138051,1527,2020-08-20
Sardegna,12,0,159,171,1262,134,1567,23,1409,158,1567,102561,121352,1134,2020-08-20
Calabria,11,1,139,151,1129,97,1377,10,1159,218,1377,139012,141046,1452,2020-08-20
Valle d'Aosta,1,0,10,11,1064,146,1221,1,1103,118,1221,16893,23753,119,2020-08-20
Molise,1,0,54,55,429,23,507,4,497,10,507,29488,30677,218,2020-08-20
Basilicata,0,0,73,73,393,28,494,2,402,92,494,51168,51958,330,2020-08-20
Lombardia,1685,156,31677,33518,88059,17152,138729,4125,116243,22486,138729,1633109,2610718,35715,2020-10-22
Piemonte,1226,79,13475,14780,30661,4227,49668,1550,26564,23104,49668,537462,906964,11565,2020-10-22
Emilia-Romagna,636,86,10941,11663,27277,4537,43477,889,35402,8075,43477,783681,1433217,16179,2020-10-22
Veneto,500,59,12049,12608,24681,2301,39590,1325,23515,16075,39590,854703,2192554,14440,2020-10-22
Campania,1037,94,21430,22561,8913,551,32025,1541,29781,2244,32025,558506,814966,12001,2020-10-22
Lazio,1293,131,17107,18531,10020,1070,29621,1251,11986,17635,29621,1002866,1227104,21575,2020-10-22
Toscana,524,82,12655,13261,12121,1229,26611,1145,20938,5673,26611,646277,962277,11495,2020-10-22
Liguria,540,34,4492,5066,13842,1673,20581,690,14535,6046,20581,207034,394365,5039,2020-10-22
Sicilia,588,89,7863,8540,5649,397,14586,796,9374,5212,14586,442472,621996,7732,2020-10-22
Puglia,448,50,5781,6279,5886,645,12810,485,3442,9368,12810,359262,507982,5651,2020-10-22
Marche,133,19,2472,2624,6570,998,10192,321,10192,0,10192,171050,292862,3776,2020-10-22
PA Trento,57,1,911,969,5927,423,7319,153,4165,3154,7319,109669,267600,1234,2020-10-22
Abruzzo,208,16,3152,3376,3214,501,7091,306,5616,1475,7091,160689,256324,3149,2020-10-22
Friuli Venezia Giulia,83,14,2128,2225,4482,368,7075,220,6490,585,7075,214444,492435,5510,2020-10-22
Sardegna,264,36,3693,3993,2712,181,6886,243,2794,4092,6886,202306,238628,3378,2020-10-22
Umbria,171,22,3077,3270,2493,97,5860,407,2240,3620,5860,156285,266398,4006,2020-10-22
PA Bolzano,106,8,2204,2318,2935,296,5549,247,5549,0,5549,109343,211011,2294,2020-10-22
Calabria,86,8,1443,1537,1644,105,3286,187,1159,2127,3286,246034,248178,3020,2020-10-22
Valle d'Aosta,48,3,854,905,1165,149,2219,87,1988,231,2219,23688,36671,681,2020-10-22
Basilicata,48,4,776,828,611,42,1481,83,453,1028,1481,91753,92593,1256,2020-10-22
Molise,13,1,436,450,594,26,1070,28,1024,46,1070,53975,57578,696,2020-10-22
Lombardia,151,14,5157,5322,75398,16844,97564,91,90487,7077,97564,855372,1432476,9000,2020-08-19
Valle d'Aosta,1,0,9,10,1064,146,1220,2,1102,118,1220,16823,23634,183,2020-08-19
Calabria,10,1,139,150,1120,97,1367,10,1159,208,1367,137560,139594,1516,2020-08-19
Sardegna,11,0,143,154,1261,134,1549,37,1398,151,1549,101544,120218,1125,2020-08-19
Umbria,9,2,84,95,1388,80,1563,4,1481,82,1563,85986,136524,1394,2020-08-19
PA Bolzano,8,1,113,122,2397,292,2811,7,2811,0,2811,65438,124586,1425,2020-08-19
Friuli Venezia Giulia,7,3,200,210,2975,348,3533,11,3477,56,3533,139117,292632,4394,2020-08-19
Abruzzo,25,2,238,265,2840,472,3577,7,3206,371,3577,92656,143041,1300,2020-08-19
Sicilia,53,8,705,766,2786,286,3838,45,3009,829,3838,243575,315870,2859,2020-08-19
Molise,0,0,51,51,429,23,503,7,493,10,503,29270,30459,249,2020-08-19
Puglia,52,3,315,370,3990,555,4915,33,1869,3046,4915,190197,273632,2694,2020-08-19
Campania,51,2,565,618,4345,440,5403,56,5274,129,5403,196936,369227,2774,2020-08-19
Marche,13,1,193,207,5871,987,7065,7,7065,0,7065,111360,186776,1640,2020-08-19
Lazio,229,6,1194,1429,6996,871,9296,75,6348,2948,9296,382387,468319,4851,2020-08-19
Liguria,23,1,319,343,8619,1569,10531,30,8619,1912,10531,115811,215615,1938,2020-08-19
Toscana,20,5,721,746,9040,1139,10925,40,10460,465,10925,314078,479103,4627,2020-08-19
Veneto,39,6,1616,1661,17615,2099,21375,59,19745,1630,21375,546505,1403390,14235,2020-08-19
Emilia-Romagna,81,7,1707,1795,24324,4455,30574,76,28722,1852,30574,467266,789983,9286,2020-08-19
Piemonte,81,3,847,931,27096,4142,32169,42,24684,7485,32169,330412,543744,3299,2020-08-19
PA Trento,2,1,41,44,4559,405,5008,2,3404,1604,5008,78156,172703,2066,2020-08-19
Basilicata,0,0,71,71,393,28,492,1,402,90,492,50838,51628,240,2020-08-19
Lombardia,150,14,5150,5314,75319,16840,97473,50,90430,7043,97473,849579,1423476,5548,2020-08-18
Valle d'Aosta,1,0,7,8,1064,146,1218,0,1100,118,1218,16690,23451,85,2020-08-18
Calabria,10,1,143,154,1106,97,1357,5,1159,198,1357,136044,138078,1474,2020-08-18
Sardegna,9,0,113,122,1256,134,1512,12,1390,122,1512,100605,119093,1009,2020-08-18
Umbria,9,1,83,93,1386,80,1559,10,1479,80,1559,85191,135130,1755,2020-08-18
PA Bolzano,8,1,118,127,2385,292,2804,0,2804,0,2804,64618,123161,639,2020-08-18
Friuli Venezia Giulia,5,3,196,204,2970,348,3522,10,3471,51,3522,137468,288238,3279,2020-08-18
Abruzzo,27,1,230,258,2840,472,3570,5,3205,365,3570,91835,141741,536,2020-08-18
Sicilia,54,6,662,722,2785,286,3793,13,2997,796,3793,241613,313011,2406,2020-08-18
Molise,0,0,44,44,429,23,496,9,486,10,496,29022,30210,179,2020-08-18
Puglia,53,3,284,340,3987,555,4882,20,1853,3029,4882,188150,270938,2644,2020-08-18
Campania,49,2,545,596,4311,440,5347,35,5220,127,5347,195069,366453,3156,2020-08-18
Marche,13,1,191,205,5866,987,7058,15,7058,0,7058,110364,185136,1127,2020-08-18
Lazio,218,6,1135,1359,6991,871,9221,43,6332,2889,9221,378384,463468,3243,2020-08-18
Liguria,25,1,296,322,8610,1569,10501,27,8613,1888,10501,114701,213677,1589,2020-08-18
Toscana,16,4,698,718,9028,1139,10885,31,10449,436,10885,311146,474476,3425,2020-08-18
Veneto,42,6,1640,1688,17530,2098,21316,60,19716,1600,21316,539471,1389155,8762,2020-08-18
Emilia-Romagna,72,4,1713,1789,24255,4454,30498,21,28693,1805,30498,463421,780697,8645,2020-08-18
Piemonte,80,3,814,897,27089,4141,32127,27,24713,7414,32127,328753,540445,3298,2020-08-18
PA Trento,2,1,56,59,4542,405,5006,2,3404,1602,5006,77285,170637,798,2020-08-18
Basilicata,0,0,70,70,393,28,491,8,402,89,491,50588,51388,379,2020-08-18
Lombardia,147,14,5174,5335,75248,16840,97423,43,90391,7032,97423,845795,1417928,4174,2020-08-17
Valle d'Aosta,1,0,7,8,1064,146,1218,1,1100,118,1218,16635,23366,145,2020-08-17
Calabria,8,1,140,149,1106,97,1352,4,1159,193,1352,134570,136604,864,2020-08-17
Sardegna,9,0,101,110,1256,134,1500,7,1385,115,1500,99783,118084,340,2020-08-17
Umbria,10,1,74,85,1384,80,1549,1,1471,78,1549,84328,133375,355,2020-08-17
PA Bolzano,8,1,118,127,2385,292,2804,2,2804,0,2804,64243,122522,566,2020-08-17
Friuli Venezia Giulia,6,3,192,201,2963,348,3512,5,3466,46,3512,136278,284959,1185,2020-08-17
Abruzzo,27,1,227,255,2838,472,3565,5,3200,365,3565,91479,141205,280,2020-08-17
Sicilia,54,6,658,718,2776,286,3780,14,2991,789,3780,240106,310605,1626,2020-08-17
Molise,0,0,35,35,429,23,487,0,477,10,487,28843,30031,73,2020-08-17
Puglia,49,2,274,325,3982,555,4862,4,1850,3012,4862,186287,268294,920,2020-08-17
Campania,47,1,519,567,4305,440,5312,34,5197,115,5312,192706,363297,1404,2020-08-17
Marche,12,1,182,195,5861,987,7043,8,7043,0,7043,109554,184009,646,2020-08-17
Lazio,212,9,1108,1329,6979,870,9178,51,6326,2852,9178,375815,460225,2271,2020-08-17
Liguria,22,3,270,295,8610,1569,10474,16,8598,1876,10474,113740,212088,824,2020-08-17
Toscana,11,4,672,687,9028,1139,10854,21,10434,420,10854,309024,471051,1643,2020-08-17
Veneto,37,4,1593,1634,17526,2096,21256,46,19699,1557,21256,533824,1380393,8566,2020-08-17
Emilia-Romagna,74,4,1736,1814,24210,4453,30477,41,28685,1792,30477,459964,772052,3113,2020-08-17
Piemonte,75,2,797,874,27086,4140,32100,16,24731,7369,32100,327181,537147,1381,2020-08-17
PA Trento,1,1,57,59,4540,405,5004,1,3403,1601,5004,76936,169839,138,2020-08-17
Basilicata,0,0,65,65,392,28,485,0,402,83,485,50219,51009,152,2020-08-17
Lombardia,147,13,5217,5377,75163,16840,97380,61,90365,7015,97380,843250,1413754,4882,2020-08-16
Valle d'Aosta,2,0,7,9,1062,146,1217,0,1099,118,1217,16543,23221,55,2020-08-16
Calabria,9,1,136,146,1105,97,1348,3,1159,189,1348,133706,135740,1676,2020-08-16
Sardegna,8,0,97,105,1254,134,1493,5,1382,111,1493,99495,117744,340,2020-08-16
Umbria,10,1,72,83,1385,80,1548,3,1471,77,1548,84080,133020,206,2020-08-16
PA Bolzano,7,1,121,129,2381,292,2802,9,2802,0,2802,63890,121956,1062,2020-08-16
Friuli Venezia Giulia,3,3,190,196,2963,348,3507,8,3463,44,3507,135467,283774,1052,2020-08-16
Abruzzo,25,1,228,254,2834,472,3560,2,3195,365,3560,91242,140925,233,2020-08-16
Sicilia,51,5,656,712,2769,285,3766,39,2986,780,3766,238872,308979,1043,2020-08-16
Molise,0,0,35,35,429,23,487,0,477,10,487,28770,29958,59,2020-08-16
Puglia,47,1,275,323,3981,554,4858,15,1847,3011,4858,185276,267374,1081,2020-08-16
Campania,43,1,489,533,4305,440,5278,46,5183,95,5278,191738,361893,3389,2020-08-16
Marche,12,1,181,194,5854,987,7035,5,7035,0,7035,109134,183363,858,2020-08-16
Lazio,204,9,1071,1284,6973,870,9127,68,6320,2807,9127,373861,457954,3016,2020-08-16
Liguria,19,3,263,285,8604,1569,10458,12,8589,1869,10458,113221,211264,1033,2020-08-16
Toscana,10,4,653,667,9028,1138,10833,34,10429,404,10833,307863,469408,1933,2020-08-16
Veneto,35,4,1568,1607,17507,2096,21210,78,19693,1517,21210,527652,1371827,8697,2020-08-16
Emilia-Romagna,74,4,1727,1805,24178,4453,30436,51,28662,1774,30436,458446,768939,3817,2020-08-16
Piemonte,80,3,782,865,27080,4139,32084,40,24733,7351,32084,326513,535766,1921,2020-08-16
PA Trento,1,1,57,59,4539,405,5003,0,3402,1601,5003,76846,169701,453,2020-08-16
Basilicata,0,0,65,65,392,28,485,0,402,83,485,50066,50857,1,2020-08-16
Lombardia,149,12,5196,5357,75125,16837,97319,94,90319,7000,97319,840083,1408872,7028,2020-08-15
Valle d'Aosta,2,0,9,11,1060,146,1217,0,1099,118,1217,16512,23166,110,2020-08-15
Calabria,8,1,134,143,1105,97,1345,10,1159,186,1345,132030,134064,1487,2020-08-15
Sardegna,8,0,93,101,1254,134,1489,5,1381,108,1489,99203,117404,654,2020-08-15
Umbria,9,1,70,80,1385,80,1545,13,1470,75,1545,83936,132814,920,2020-08-15
PA Bolzano,7,1,118,126,2375,292,2793,9,2793,0,2793,63420,120894,1463,2020-08-15
Friuli Venezia Giulia,2,3,184,189,2962,348,3499,15,3455,44,3499,134780,282722,3340,2020-08-15
Abruzzo,25,1,226,252,2834,472,3558,13,3196,362,3558,91060,140692,1266,2020-08-15
Sicilia,47,5,625,677,2766,284,3727,46,2979,748,3727,237998,307936,2030,2020-08-15
Molise,0,0,35,35,429,23,487,2,477,10,487,28711,29899,221,2020-08-15
Puglia,46,1,261,308,3981,554,4843,22,1844,2999,4843,184587,266293,1745,2020-08-15
Campania,34,1,454,489,4303,440,5232,18,5142,90,5232,189377,358504,1723,2020-08-15
Marche,13,1,180,194,5849,987,7030,11,7030,0,7030,108605,182505,1135,2020-08-15
Lazio,193,9,1016,1218,6971,870,9059,58,6308,2751,9059,371681,454938,2602,2020-08-15
Liguria,17,3,253,273,8604,1569,10446,33,8584,1862,10446,112680,210231,1921,2020-08-15
Toscana,9,4,620,633,9028,1138,10799,38,10419,380,10799,306566,467475,3767,2020-08-15
Veneto,38,4,1518,1560,17476,2096,21132,120,19673,1459,21132,524443,1363130,11772,2020-08-15
Emilia-Romagna,75,4,1675,1754,24178,4453,30385,71,28642,1743,30385,456025,765122,6089,2020-08-15
Piemonte,81,3,796,880,27025,4139,32044,47,24747,7297,32044,324996,533845,2220,2020-08-15
PA Trento,1,1,58,60,4538,405,5003,0,3402,1601,5003,76702,169248,1400,2020-08-15
Basilicata,0,0,66,66,392,28,486,4,402,84,486,50066,50856,230,2020-08-15
Lombardia,153,12,5212,5377,75012,16836,97225,97,90249,6976,97225,837083,1401844,7464,2020-08-14
Piemonte,77,3,794,874,26984,4139,31997,15,24812,7185,31997,323723,531625,1241,2020-08-14
Emilia-Romagna,76,4,1786,1866,24150,4298,30314,57,28611,1703,30314,452995,759033,6376,2020-08-14
Veneto,33,6,1431,1470,17447,2095,21012,127,19639,1373,21012,521232,1351358,8644,2020-08-14
Toscana,12,3,589,604,9020,1137,10761,26,10412,349,10761,304412,463708,3014,2020-08-14
Liguria,17,3,252,272,8572,1569,10413,20,8561,1852,10413,111663,208310,1506,2020-08-14
Lazio,192,9,964,1165,6966,870,9001,45,6296,2705,9001,369749,452336,2450,2020-08-14
Marche,10,1,179,190,5842,987,7019,32,7019,0,7019,107918,181370,1280,2020-08-14
Campania,47,1,439,487,4287,440,5214,44,5124,90,5214,188242,356781,2235,2020-08-14
PA Trento,2,1,60,63,4535,405,5003,3,3402,1601,5003,76300,167848,1421,2020-08-14
Puglia,45,1,240,286,3981,554,4821,12,1835,2986,4821,183493,264548,1701,2020-08-14
Sicilia,46,6,579,631,2766,284,3681,36,2964,717,3681,236593,305906,2219,2020-08-14
Abruzzo,23,1,218,242,2831,472,3545,13,3186,359,3545,90264,139426,745,2020-08-14
Friuli Venezia Giulia,3,3,177,183,2953,348,3484,8,3442,42,3484,133870,279382,2222,2020-08-14
PA Bolzano,7,1,115,123,2369,292,2784,3,2784,0,2784,62599,119431,1019,2020-08-14
Umbria,10,0,58,68,1384,80,1532,8,1467,65,1532,83413,131894,853,2020-08-14
Sardegna,8,0,95,103,1247,134,1484,5,1381,103,1484,98662,116750,573,2020-08-14
Calabria,7,1,125,133,1105,97,1335,19,1159,176,1335,130543,132577,1185,2020-08-14
Valle d'Aosta,3,0,10,13,1058,146,1217,0,1099,118,1217,16436,23056,118,2020-08-14
Molise,0,0,35,35,427,23,485,0,475,10,485,28498,29678,79,2020-08-14
Basilicata,0,0,64,64,390,28,482,4,402,80,482,49836,50626,378,2020-08-14
Lombardia,170,11,5358,5539,74754,16835,97128,74,90188,6940,97128,833060,1394380,7174,2020-08-13
Valle d'Aosta,3,0,11,14,1057,146,1217,0,1099,118,1217,16397,22938,99,2020-08-13
Calabria,8,1,110,119,1100,97,1316,12,1159,157,1316,129359,131392,1164,2020-08-13
Sardegna,8,0,90,98,1247,134,1479,17,1379,100,1479,98236,116177,1159,2020-08-13
Umbria,10,0,52,62,1382,80,1524,7,1464,60,1524,83046,131041,796,2020-08-13
PA Bolzano,7,1,114,122,2367,292,2781,3,2781,0,2781,61905,118412,1590,2020-08-13
Friuli Venezia Giulia,7,3,166,176,2952,348,3476,15,3434,42,3476,133284,277160,2517,2020-08-13
Abruzzo,24,1,209,234,2826,472,3532,16,3174,358,3532,89847,138681,905,2020-08-13
Sicilia,42,6,556,604,2757,284,3645,42,2956,689,3645,234950,303687,2046,2020-08-13
Molise,0,0,35,35,427,23,485,6,475,10,485,28421,29599,156,2020-08-13
Puglia,46,2,228,276,3979,554,4809,16,1838,2971,4809,182067,262847,1746,2020-08-13
Campania,38,2,407,447,4283,440,5170,27,5082,88,5170,186543,354546,1708,2020-08-13
Marche,8,0,161,169,5831,987,6987,11,6987,0,6987,107237,180090,1302,2020-08-13
Lazio,195,9,923,1127,6960,869,8956,36,6290,2666,8956,367897,449886,2211,2020-08-13
Liguria,20,2,235,257,8567,1569,10393,63,8542,1851,10393,110755,206804,1704,2020-08-13
Toscana,13,3,574,590,9008,1137,10735,28,10407,328,10735,302546,460694,3128,2020-08-13
Veneto,30,6,1349,1385,17406,2094,20885,84,19612,1273,20885,518924,1342714,10065,2020-08-13
Emilia-Romagna,79,4,1744,1827,24132,4298,30257,37,28581,1676,30257,449766,752657,7168,2020-08-13
Piemonte,77,3,784,864,26979,4139,31982,26,24807,7175,31982,322956,530384,2796,2020-08-13
PA Trento,1,1,61,63,4532,405,5000,2,3401,1599,5000,76012,166427,1425,2020-08-13
Basilicata,0,0,73,73,377,28,478,1,402,76,478,49448,50248,329,2020-08-13
Lombardia,165,10,5346,5521,74700,16833,97054,102,90150,6904,97054,829237,1387206,7960,2020-08-12
Valle d'Aosta,5,0,10,15,1056,146,1217,0,1099,118,1217,16342,22839,208,2020-08-12
Calabria,8,1,101,110,1097,97,1304,4,1159,145,1304,128194,130228,1092,2020-08-12
Sardegna,6,0,77,83,1245,134,1462,1,1377,85,1462,97340,115018,747,2020-08-12
Umbria,9,0,48,57,1380,80,1517,6,1459,58,1517,82645,130245,944,2020-08-12
PA Bolzano,6,0,124,130,2357,292,2779,4,2779,0,2779,60969,116822,1708,2020-08-12
Friuli Venezia Giulia,7,3,154,164,2949,348,3461,9,3428,33,3461,132663,274643,2485,2020-08-12
Abruzzo,23,1,197,221,2823,472,3516,9,3166,350,3516,89381,137776,981,2020-08-12
Sicilia,43,6,513,562,2757,284,3603,29,2939,664,3603,233597,301641,2248,2020-08-12
Molise,0,0,29,29,427,23,479,0,475,4,479,28265,29443,172,2020-08-12
Puglia,43,2,217,262,3977,554,4793,33,1836,2957,4793,180855,261101,2123,2020-08-12
Campania,43,2,379,424,4279,440,5143,29,5056,87,5143,185318,352838,1333,2020-08-12
Marche,10,0,157,167,5822,987,6976,16,6976,0,6976,106614,178788,1029,2020-08-12
Lazio,190,9,922,1121,6931,868,8920,37,6276,2644,8920,366246,447675,2695,2020-08-12
Liguria,17,2,208,227,8534,1569,10330,26,8481,1849,10330,109799,205100,1775,2020-08-12
Toscana,15,3,545,563,9007,1137,10707,33,10402,305,10707,300764,457566,3173,2020-08-12
Veneto,33,6,1294,1333,17376,2092,20801,60,19579,1222,20801,516131,1332649,9841,2020-08-12
Emilia-Romagna,78,4,1725,1807,24115,4298,30220,41,28564,1656,30220,446202,745489,7740,2020-08-12
Piemonte,76,3,776,855,26963,4138,31956,42,24841,7115,31956,321651,527588,2739,2020-08-12
PA Trento,2,1,65,68,4525,405,4998,0,3400,1598,4998,75685,165002,1387,2020-08-12
Basilicata,0,0,72,72,377,28,477,0,402,75,477,49129,49919,278,2020-08-12
Lombardia,160,10,5344,5514,74605,16833,96952,68,90081,6871,96952,824917,1379246,4537,2020-08-11
Valle d'Aosta,5,0,10,15,1056,146,1217,0,1099,118,1217,16228,22631,107,2020-08-11
Calabria,8,1,103,112,1091,97,1300,11,1159,141,1300,127102,129136,946,2020-08-11
Sardegna,6,0,76,82,1245,134,1461,20,1377,84,1461,96725,114271,866,2020-08-11
Umbria,9,0,43,52,1379,80,1511,1,1458,53,1511,82253,129301,1003,2020-08-11
PA Bolzano,6,0,122,128,2355,292,2775,1,2775,0,2775,59794,115114,484,2020-08-11
Friuli Venezia Giulia,8,3,145,156,2948,348,3452,3,3420,32,3452,132027,272158,2367,2020-08-11
Abruzzo,23,1,195,219,2821,472,3512,3,3166,346,3512,88902,136795,430,2020-08-11
Sicilia,44,6,488,538,2752,284,3574,89,2927,647,3574,231949,299393,2860,2020-08-11
Molise,1,0,32,33,423,23,479,0,475,4,479,28105,29271,109,2020-08-11
Puglia,38,1,190,229,3977,554,4760,20,1823,2937,4760,179205,258978,1981,2020-08-11
Campania,44,2,356,402,4272,440,5114,23,5027,87,5114,184220,351505,1142,2020-08-11
Marche,11,0,151,162,5811,987,6960,4,6960,0,6960,106017,177759,929,2020-08-11
Lazio,203,9,889,1101,6915,867,8883,23,6264,2619,8883,364395,444980,2147,2020-08-11
Liguria,18,2,203,223,8512,1569,10304,11,8462,1842,10304,108894,203325,1317,2020-08-11
Toscana,18,1,516,535,9002,1137,10674,22,10397,277,10674,298892,454393,2972,2020-08-11
Veneto,33,6,1261,1300,17356,2085,20741,65,19561,1180,20741,513323,1322808,6921,2020-08-11
Emilia-Romagna,76,4,1710,1790,24091,4298,30179,19,28546,1633,30179,442538,737749,5900,2020-08-11
Piemonte,85,3,734,822,26956,4136,31914,26,24895,7019,31914,319943,524849,2749,2020-08-11
PA Trento,5,0,70,75,4518,405,4998,2,3400,1598,4998,75417,163615,626,2020-08-11
Basilicata,0,0,73,73,376,28,477,1,402,75,477,48851,49641,249,2020-08-11
Lombardia,150,9,5388,5547,74504,16833,96884,31,90038,6846,96884,822142,1374709,9343,2020-08-10
Valle d'Aosta,5,0,10,15,1056,146,1217,1,1099,118,1217,16161,22524,86,2020-08-10
Calabria,8,1,92,101,1091,97,1289,2,1159,130,1289,126156,128190,327,2020-08-10
Sardegna,6,0,56,62,1245,134,1441,2,1375,66,1441,95974,113405,339,2020-08-10
Umbria,8,0,46,54,1376,80,1510,5,1457,53,1510,81825,128298,290,2020-08-10
PA Bolzano,8,0,120,128,2354,292,2774,1,2774,0,2774,59515,114630,493,2020-08-10
Friuli Venezia Giulia,10,3,151,164,2938,347,3449,0,3418,31,3449,131332,269791,653,2020-08-10
Sicilia,45,6,399,450,2751,284,3485,32,2910,575,3485,230105,296533,873,2020-08-10
Abruzzo,24,1,194,219,2818,472,3509,7,3175,334,3509,88650,136365,151,2020-08-10
Molise,1,0,32,33,423,23,479,0,475,4,479,28003,29162,77,2020-08-10
Puglia,36,1,176,213,3973,554,4740,26,1818,2922,4740,177798,256997,690,2020-08-10
Campania,34,1,363,398,4254,439,5091,14,5004,87,5091,183401,350363,741,2020-08-10
Marche,11,0,154,165,5804,987,6956,2,6956,0,6956,105420,176830,548,2020-08-10
Lazio,195,8,878,1081,6912,867,8860,38,6260,2600,8860,362827,442833,2323,2020-08-10
Liguria,20,2,190,212,8512,1569,10293,10,8455,1838,10293,108164,202008,738,2020-08-10
Toscana,16,1,501,518,8997,1137,10652,8,10377,275,10652,297261,451421,1387,2020-08-10
Veneto,29,6,1222,1257,17336,2083,20676,20,19543,1133,20676,510459,1315887,1610,2020-08-10
Emilia-Romagna,79,4,1708,1791,24073,4296,30160,39,28533,1627,30160,440041,731849,4156,2020-08-10
Piemonte,87,3,719,809,26943,4136,31888,20,24928,6960,31888,318659,522100,1029,2020-08-10
PA Trento,7,0,72,79,4512,405,4996,1,3400,1596,4996,75139,162989,305,2020-08-10
Basilicata,0,0,72,72,376,28,476,0,402,74,476,48602,49392,273,2020-08-10
Lombardia,155,9,5424,5588,74432,16833,96853,71,90015,6838,96853,820541,1365366,6494,2020-08-09
Valle d'Aosta,5,0,9,14,1056,146,1216,0,1098,118,1216,16120,22438,98,2020-08-09
Calabria,9,1,90,100,1090,97,1287,0,1159,128,1287,125829,127863,554,2020-08-09
Sardegna,6,0,54,60,1245,134,1439,6,1375,64,1439,95686,113066,455,2020-08-09
Umbria,8,0,41,49,1376,80,1505,7,1457,48,1505,81605,128008,520,2020-08-09
PA Bolzano,8,0,120,128,2353,292,2773,7,2773,0,2773,59260,114137,1209,2020-08-09
Friuli Venezia Giulia,11,3,152,166,2937,346,3449,7,3418,31,3449,131023,269138,1277,2020-08-09
Sicilia,39,5,376,420,2749,284,3453,29,2896,557,3453,229444,295660,1277,2020-08-09
Abruzzo,23,1,189,213,2817,472,3502,16,3174,328,3502,88565,136214,1234,2020-08-09
Molise,1,0,34,35,421,23,479,0,475,4,479,27928,29085,79,2020-08-09
Puglia,31,0,156,187,3973,554,4714,9,1806,2908,4714,176992,256307,1368,2020-08-09
Campania,29,2,357,388,4251,438,5077,22,4990,87,5077,182840,349622,1675,2020-08-09
Marche,13,0,155,168,5799,987,6954,16,6954,0,6954,105247,176282,1260,2020-08-09
Lazio,189,8,849,1046,6910,866,8822,38,6251,2571,8822,361238,440510,2612,2020-08-09
Liguria,20,2,194,216,8498,1569,10283,7,8447,1836,10283,107771,201270,2022,2020-08-09
Toscana,14,1,495,510,8997,1137,10644,61,10370,274,10644,296406,450034,2784,2020-08-09
Veneto,28,6,1206,1240,17333,2083,20656,58,19536,1120,20656,509851,1314277,4360,2020-08-09
Emilia-Romagna,81,4,1675,1760,24066,4295,30121,69,28516,1605,30121,438547,727693,5413,2020-08-09
Piemonte,85,3,734,822,26910,4136,31868,38,24929,6939,31868,318480,521071,2037,2020-08-09
PA Trento,6,0,72,78,4512,405,4995,2,3399,1596,4995,75038,162684,909,2020-08-09
Basilicata,2,0,73,75,373,28,476,0,402,74,476,48319,49119,0,2020-08-09
Lombardia,162,9,5376,5547,74403,16832,96782,76,89970,6812,96782,816988,1358872,6382,2020-08-08
Valle d'Aosta,5,0,14,19,1051,146,1216,2,1098,118,1216,16048,22340,110,2020-08-08
Calabria,9,1,91,101,1089,97,1287,4,1159,128,1287,125275,127309,875,2020-08-08
Sardegna,6,0,48,54,1245,134,1433,0,1374,59,1433,95280,112611,992,2020-08-08
Umbria,8,0,34,42,1376,80,1498,10,1456,42,1498,81336,127488,834,2020-08-08
PA Bolzano,8,0,115,123,2351,292,2766,5,2766,0,2766,58633,112928,1115,2020-08-08
Sicilia,37,4,356,397,2743,284,3424,28,2885,539,3424,228395,294383,2511,2020-08-08
Friuli Venezia Giulia,11,3,146,160,2936,346,3442,6,3413,29,3442,130500,267861,1830,2020-08-08
Abruzzo,24,1,172,197,2817,472,3486,12,3160,326,3486,87799,134980,712,2020-08-08
Molise,1,0,34,35,421,23,479,0,475,4,479,27851,29006,166,2020-08-08
Puglia,27,0,151,178,3973,554,4705,9,1805,2900,4705,176113,254939,1561,2020-08-08
Campania,32,2,338,372,4245,438,5055,5,4970,85,5055,181846,347947,1972,2020-08-08
Marche,14,0,142,156,5795,987,6938,3,6937,1,6938,104534,175022,1297,2020-08-08
Lazio,189,8,820,1017,6901,866,8784,20,6239,2545,8784,359225,437898,2381,2020-08-08
Liguria,20,1,193,214,8493,1569,10276,4,8447,1829,10276,105987,199248,1004,2020-08-08
Toscana,14,1,442,457,8989,1137,10583,23,10311,272,10583,294690,447250,2917,2020-08-08
Veneto,29,6,1193,1228,17287,2083,20598,63,19517,1081,20598,508892,1309917,14171,2020-08-08
Emilia-Romagna,81,4,1627,1712,24046,4294,30052,44,28490,1562,30052,434744,722280,8147,2020-08-08
Piemonte,87,3,700,790,26904,4136,31830,31,24959,6871,31830,316746,519034,2448,2020-08-08
PA Trento,5,0,74,79,4509,405,4993,1,3399,1594,4993,74756,161775,1636,2020-08-08
Basilicata,2,0,73,75,373,28,476,1,402,74,476,48319,49119,237,2020-08-08
Lombardia,170,9,5466,5645,74232,16829,96706,69,89924,6782,96706,813260,1352490,8128,2020-08-07
Valle d'Aosta,5,0,12,17,1051,146,1214,4,1096,118,1214,15985,22230,65,2020-08-07
Calabria,7,1,89,97,1089,97,1283,7,1159,124,1283,124400,126434,1041,2020-08-07
Sardegna,8,0,50,58,1241,134,1433,3,1374,59,1433,94626,111619,798,2020-08-07
Umbria,8,0,25,33,1375,80,1488,6,1455,33,1488,80959,126654,885,2020-08-07
PA Bolzano,8,0,120,128,2341,292,2761,4,2761,0,2761,57987,111813,1110,2020-08-07
Sicilia,37,4,328,369,2743,284,3396,27,2866,530,3396,226979,291872,2412,2020-08-07
Friuli Venezia Giulia,13,3,139,155,2935,346,3436,4,3407,29,3436,129930,266031,2146,2020-08-07
Abruzzo,22,1,167,190,2812,472,3474,39,3178,296,3474,87440,134268,923,2020-08-07
Molise,1,0,34,35,421,23,479,1,475,4,479,27685,28840,155,2020-08-07
Puglia,26,0,144,170,3973,553,4696,11,1844,2852,4696,174742,253378,1908,2020-08-07
Campania,32,2,338,372,4240,438,5050,15,4968,82,5050,180679,345975,2025,2020-08-07
Marche,13,0,145,158,5790,987,6935,21,6934,1,6935,103904,173725,1049,2020-08-07
Lazio,184,8,816,1008,6891,865,8764,20,6231,2533,8764,357556,435517,2341,2020-08-07
Liguria,22,1,193,216,8488,1568,10272,9,8445,1827,10272,105914,198244,1327,2020-08-07
Toscana,18,0,417,435,8988,1137,10560,13,10292,268,10560,292933,444333,2657,2020-08-07
Veneto,31,6,1178,1215,17242,2078,20535,183,19503,1032,20535,505441,1295746,16494,2020-08-07
Emilia-Romagna,79,4,1592,1675,24041,4292,30008,54,28476,1532,30008,429300,714133,9511,2020-08-07
Piemonte,88,3,701,792,26871,4136,31799,37,25012,6787,31799,315167,516586,2661,2020-08-07
PA Trento,5,0,77,82,4505,405,4992,4,3399,1593,4992,74347,160139,1251,2020-08-07
Basilicata,2,0,72,74,373,28,475,21,402,73,475,48092,48882,309,2020-08-07
Lombardia,168,11,5549,5728,74080,16829,96637,118,89887,6750,96637,808787,1344362,8979,2020-08-06
Valle d'Aosta,1,0,12,13,1051,146,1210,1,1092,118,1210,15940,22165,182,2020-08-06
Calabria,7,1,83,91,1088,97,1276,2,1159,117,1276,123359,125393,867,2020-08-06
Sardegna,7,0,48,55,1241,134,1430,3,1374,56,1430,93975,110821,939,2020-08-06
Umbria,8,0,21,29,1373,80,1482,3,1455,27,1482,80599,125769,914,2020-08-06
PA Bolzano,8,0,116,124,2341,292,2757,12,2757,0,2757,57346,110703,1238,2020-08-06
Sicilia,37,4,301,342,2743,284,3369,30,2853,516,3369,225491,289460,2795,2020-08-06
Friuli Venezia Giulia,11,2,140,153,2933,346,3432,7,3404,28,3432,129283,263885,2347,2020-08-06
Abruzzo,20,1,132,153,2810,472,3435,15,3149,286,3435,86980,133345,1029,2020-08-06
Molise,1,0,33,34,421,23,478,0,475,3,478,27530,28685,184,2020-08-06
Puglia,24,0,134,158,3974,553,4685,7,1892,2793,4685,173426,251470,2259,2020-08-06
Campania,20,1,364,385,4212,438,5035,5,4957,78,5035,179583,343950,2919,2020-08-06
Marche,16,0,125,141,5786,987,6914,9,6911,3,6914,103309,172676,1224,2020-08-06
Lazio,185,8,800,993,6886,865,8744,18,6223,2521,8744,355838,433176,3628,2020-08-06
Liguria,20,0,190,210,8485,1568,10263,13,8443,1820,10263,105218,196917,1575,2020-08-06
Toscana,20,0,405,425,8985,1137,10547,17,10287,260,10547,291429,441676,3042,2020-08-06
Veneto,36,6,1055,1097,17178,2077,20352,58,19484,868,20352,499706,1279252,9402,2020-08-06
Emilia-Romagna,78,4,1570,1652,24011,4291,29954,58,28454,1500,29954,423543,704622,10114,2020-08-06
Piemonte,90,4,684,778,26849,4135,31762,22,25058,6704,31762,313748,513925,3193,2020-08-06
PA Trento,3,0,77,80,4503,405,4988,4,3397,1591,4988,74061,158888,1476,2020-08-06
Basilicata,2,0,51,53,373,28,454,0,402,52,454,47783,48573,367,2020-08-06
Lombardia,164,11,5648,5823,73872,16824,96519,138,89814,6705,96519,803355,1335383,9260,2020-08-05
Valle d'Aosta,1,0,11,12,1051,146,1209,0,1091,118,1209,15855,21983,58,2020-08-05
Calabria,6,1,94,101,1076,97,1274,2,1159,115,1274,122492,124526,1058,2020-08-05
Sardegna,5,0,48,53,1240,134,1427,9,1374,53,1427,93176,109882,1032,2020-08-05
Umbria,6,0,24,30,1369,80,1479,2,1452,27,1479,80145,124855,1131,2020-08-05
PA Bolzano,8,0,108,116,2337,292,2745,5,2745,0,2745,56638,109465,1294,2020-08-05
Sicilia,34,4,276,314,2741,284,3339,21,2840,499,3339,223645,286665,2337,2020-08-05
Abruzzo,19,1,120,140,2808,472,3420,19,3160,260,3420,86563,132316,884,2020-08-05
Friuli Venezia Giulia,8,2,137,147,2932,346,3425,9,3400,25,3425,128698,261538,2891,2020-08-05
Molise,1,0,33,34,421,23,478,1,475,3,478,27346,28501,152,2020-08-05
Puglia,24,0,128,152,3973,553,4678,23,1919,2759,4678,171932,249211,2630,2020-08-05
Campania,44,1,349,394,4198,438,5030,8,4953,77,5030,177414,341031,2085,2020-08-05
Marche,15,0,122,137,5781,987,6905,6,6905,0,6905,102536,171452,1173,2020-08-05
Lazio,188,7,788,983,6878,865,8726,12,6220,2506,8726,353130,429548,2877,2020-08-05
Liguria,18,0,189,207,8475,1568,10250,7,8440,1810,10250,104340,195342,1623,2020-08-05
Toscana,18,0,397,415,8978,1137,10530,11,10282,248,10530,289710,438634,3893,2020-08-05
Veneto,33,6,1028,1067,17150,2077,20294,41,19465,829,20294,496893,1269850,9447,2020-08-05
Emilia-Romagna,73,4,1532,1609,23997,4291,29897,47,28438,1459,29897,418046,694508,8523,2020-08-05
Piemonte,94,4,682,780,26826,4134,31740,21,25113,6627,31740,311770,510732,2598,2020-08-05
PA Trento,3,0,76,79,4500,405,4984,1,3397,1587,4984,73665,157412,1231,2020-08-05
Basilicata,2,0,51,53,373,28,454,1,402,52,454,47416,48206,274,2020-08-05
Lombardia,160,9,5583,5752,73810,16819,96381,44,89704,6677,96381,797918,1326123,5696,2020-08-04
Valle d'Aosta,1,0,12,13,1050,146,1209,0,1091,118,1209,15819,21925,137,2020-08-04
Calabria,6,1,92,99,1076,97,1272,2,1159,113,1272,121434,123468,867,2020-08-04
Sardegna,3,0,42,45,1239,134,1418,2,1370,48,1418,92306,108850,1014,2020-08-04
Umbria,7,0,22,29,1368,80,1477,2,1451,26,1477,79586,123724,1059,2020-08-04
PA Bolzano,7,0,111,118,2330,292,2740,6,2740,0,2740,56024,108171,436,2020-08-04
Sicilia,34,3,256,293,2741,284,3318,10,2832,486,3318,222225,284328,2670,2020-08-04
Abruzzo,18,1,106,125,2804,472,3401,3,3141,260,3401,86079,131432,555,2020-08-04
Friuli Venezia Giulia,7,2,129,138,2932,346,3416,5,3391,25,3416,127931,258647,2299,2020-08-04
Molise,1,0,32,33,421,23,477,0,475,2,477,27197,28349,128,2020-08-04
Puglia,22,0,109,131,3971,553,4655,7,1995,2660,4655,170642,246581,2407,2020-08-04
Campania,44,2,346,392,4194,436,5022,2,4946,76,5022,175739,338946,928,2020-08-04
Marche,15,0,124,139,5773,987,6899,2,6899,0,6899,101871,170279,1154,2020-08-04
Lazio,179,8,800,987,6863,864,8714,17,6219,2495,8714,351191,426671,2388,2020-08-04
Liguria,22,0,178,200,8475,1568,10243,5,8446,1797,10243,103441,193719,1050,2020-08-04
Toscana,18,0,387,405,8977,1137,10519,11,10278,241,10519,287473,434741,2673,2020-08-04
Veneto,32,5,1028,1065,17111,2077,20253,20,19446,807,20253,494299,1260403,7160,2020-08-04
Emilia-Romagna,79,4,1498,1581,23978,4291,29850,42,28425,1425,29850,412865,685985,7384,2020-08-04
Piemonte,101,6,691,798,26789,4132,31719,8,25147,6572,31719,310492,508134,3161,2020-08-04
PA Trento,3,0,85,88,4490,405,4983,2,3397,1586,4983,73352,156181,396,2020-08-04
Basilicata,2,0,49,51,374,28,453,0,402,51,453,47142,47932,226,2020-08-04
Lombardia,162,9,5624,5795,73724,16818,96337,25,89689,6648,96337,794279,1320427,4208,2020-08-03
Valle d'Aosta,1,0,12,13,1050,146,1209,0,1074,135,1209,15732,21788,89,2020-08-03
Calabria,5,1,92,98,1075,97,1270,0,1159,111,1270,120567,122601,239,2020-08-03
Sardegna,3,0,41,44,1238,134,1416,2,1370,46,1416,91739,107836,420,2020-08-03
Umbria,7,0,20,27,1368,80,1475,1,1451,24,1475,79126,122665,261,2020-08-03
PA Bolzano,7,0,105,112,2330,292,2734,6,2734,0,2734,55757,107735,537,2020-08-03
Sicilia,36,3,249,288,2737,283,3308,3,2824,484,3308,220629,281658,823,2020-08-03
Abruzzo,16,1,107,124,2802,472,3398,9,3139,259,3398,85744,130877,124,2020-08-03
Friuli Venezia Giulia,9,3,124,136,2929,346,3411,0,3388,23,3411,127228,256348,568,2020-08-03
Molise,1,0,32,33,421,23,477,2,475,2,477,27070,28221,83,2020-08-03
Puglia,23,0,102,125,3970,553,4648,9,1994,2654,4648,168787,244174,865,2020-08-03
Campania,47,2,348,397,4187,436,5020,4,4944,76,5020,174985,338018,826,2020-08-03
Marche,13,0,127,140,5770,987,6897,0,6897,0,6897,101386,169125,93,2020-08-03
Lazio,174,9,791,974,6859,864,8697,15,6209,2488,8697,349522,424283,2419,2020-08-03
Liguria,21,0,174,195,8475,1568,10238,2,8468,1770,10238,102878,192669,608,2020-08-03
Toscana,16,1,381,398,8974,1136,10508,10,10270,238,10508,285916,432068,1492,2020-08-03
Veneto,25,4,1022,1051,17106,2076,20233,22,19436,797,20233,491567,1253243,3068,2020-08-03
Emilia-Romagna,68,3,1489,1560,23957,4291,29808,34,28403,1405,29808,409341,678601,5357,2020-08-03
Piemonte,95,5,713,813,26767,4131,31711,13,25169,6542,31711,309217,504973,1295,2020-08-03
PA Trento,3,0,97,100,4476,405,4981,2,3396,1585,4981,73149,155785,385,2020-08-03
Basilicata,2,0,49,51,374,28,453,0,402,51,453,46916,47706,276,2020-08-03
Lombardia,153,9,5659,5821,73676,16815,96312,38,89676,6636,96312,791698,1316219,7712,2020-08-02
Valle d'Aosta,1,0,12,13,1050,146,1209,1,1074,135,1209,15680,21699,111,2020-08-02
Calabria,5,1,92,98,1075,97,1270,1,1159,111,1270,120328,122362,559,2020-08-02
Sardegna,3,0,40,43,1237,134,1414,4,1369,45,1414,91373,107416,377,2020-08-02
Umbria,7,0,19,26,1368,80,1474,2,1451,23,1474,78969,122404,620,2020-08-02
PA Bolzano,7,0,100,107,2329,292,2728,3,2728,0,2728,55385,107198,1029,2020-08-02
Sicilia,36,3,246,285,2737,283,3305,7,2822,483,3305,220126,280835,1319,2020-08-02
Abruzzo,16,1,99,116,2801,472,3389,2,3138,251,3389,85639,130753,1152,2020-08-02
Friuli Venezia Giulia,9,3,125,137,2929,345,3411,10,3382,29,3411,126943,255780,1617,2020-08-02
Molise,1,0,30,31,421,23,475,2,473,2,475,26987,28138,289,2020-08-02
Puglia,20,0,100,120,3967,552,4639,8,1994,2645,4639,167514,243309,1473,2020-08-02
Campania,35,3,363,401,4180,435,5016,7,4940,76,5016,174273,337192,2194,2020-08-02
Marche,11,0,136,147,5763,987,6897,8,6897,0,6897,101330,169032,1086,2020-08-02
Lazio,176,9,779,964,6855,863,8682,17,6203,2479,8682,347749,421864,2793,2020-08-02
Liguria,20,0,196,216,8453,1567,10236,6,8477,1759,10236,102520,192061,1312,2020-08-02
Toscana,15,0,382,397,8966,1135,10498,9,10263,235,10498,285083,430576,2815,2020-08-02
Veneto,27,4,1003,1034,17102,2075,20211,45,19433,778,20211,490763,1250175,6474,2020-08-02
Emilia-Romagna,68,4,1468,1540,23943,4291,29774,49,28392,1382,29774,407452,673244,7503,2020-08-02
Piemonte,95,5,710,810,26759,4129,31698,15,25209,6489,31698,308574,503678,1894,2020-08-02
PA Trento,1,0,98,99,4475,405,4979,4,3395,1584,4979,73042,155400,939,2020-08-02
Basilicata,2,0,49,51,374,28,453,1,402,51,453,46640,47430,1,2020-08-02
Lombardia,158,9,5788,5955,73512,16807,96274,55,89651,6623,96274,787173,1308507,8419,2020-08-01
Valle d'Aosta,1,0,11,12,1050,146,1208,0,1090,118,1208,15609,21588,56,2020-08-01
Calabria,4,1,92,97,1075,97,1269,3,1159,110,1269,119769,121803,1135,2020-08-01
Sardegna,4,0,35,39,1237,134,1410,6,1366,44,1410,91026,107039,694,2020-08-01
Umbria,7,0,17,24,1368,80,1472,6,1450,22,1472,78643,121784,888,2020-08-01
PA Bolzano,6,1,100,107,2326,292,2725,8,2725,0,2725,54755,106169,952,2020-08-01
Sicilia,36,3,242,281,2734,283,3298,10,2816,482,3298,219093,279516,2743,2020-08-01
Abruzzo,13,1,101,115,2800,472,3387,5,3142,245,3387,85021,129601,1118,2020-08-01
Friuli Venezia Giulia,8,3,118,129,2927,345,3401,7,3380,21,3401,126425,254163,2542,2020-08-01
Molise,1,0,28,29,421,23,473,2,471,2,473,26698,27849,170,2020-08-01
Puglia,19,0,93,112,3967,552,4631,20,1992,2639,4631,166712,241836,1832,2020-08-01
Campania,39,3,355,397,4177,435,5009,10,4933,76,5009,172579,334998,2162,2020-08-01
Marche,8,0,136,144,5758,987,6889,5,6889,0,6889,100767,167946,730,2020-08-01
Lazio,172,9,769,950,6852,863,8665,18,6198,2467,8665,345548,419071,2150,2020-08-01
Liguria,19,0,194,213,8450,1567,10230,16,8474,1756,10230,101716,190749,1727,2020-08-01
Toscana,16,0,376,392,8962,1135,10489,6,10255,234,10489,283394,427761,3187,2020-08-01
Veneto,28,4,969,1001,17090,2075,20166,46,19420,746,20166,489602,1243701,15286,2020-08-01
Emilia-Romagna,67,4,1439,1510,23925,4291,29726,56,28373,1353,29726,402424,665741,2911,2020-08-01
Piemonte,96,5,700,801,26753,4129,31683,16,25235,6448,31683,307168,501784,2658,2020-08-01
PA Trento,1,0,98,99,4471,405,4975,0,3394,1581,4975,72811,154461,1294,2020-08-01
Basilicata,2,0,48,50,374,28,452,0,402,50,452,46639,47429,229,2020-08-01
Lombardia,151,13,5871,6035,73305,16802,96142,88,89655,6487,96142,775765,1291740,11207,2020-07-30
Valle d'Aosta,1,0,11,12,1050,146,1208,0,1090,118,1208,15516,21408,121,2020-07-30
Calabria,3,1,89,93,1072,97,1262,7,1159,103,1262,117676,119710,1118,2020-07-30
Sardegna,3,0,20,23,1237,134,1394,0,1365,29,1394,89608,105701,698,2020-07-30
Umbria,7,0,10,17,1368,80,1465,0,1444,21,1465,77819,120199,940,2020-07-30
PA Bolzano,6,1,85,92,2318,292,2702,6,2702,0,2702,53491,104108,1104,2020-07-30
Sicilia,33,2,224,259,2730,283,3272,39,2798,474,3272,216010,274288,3191,2020-07-30
Abruzzo,14,1,91,106,2799,472,3377,4,3136,241,3377,83816,127417,972,2020-07-30
Friuli Venezia Giulia,9,2,111,122,2924,345,3391,13,3376,15,3391,124938,249091,2835,2020-07-30
Molise,1,0,25,26,421,23,470,0,468,2,470,26384,27535,152,2020-07-30
Puglia,17,0,77,94,3964,551,4609,3,1990,2619,4609,163824,238142,2441,2020-07-30
Campania,49,6,344,399,4157,434,4990,16,4914,76,4990,169546,329863,2076,2020-07-30
Marche,6,0,124,130,5746,987,6863,8,6863,0,6863,99696,166234,1178,2020-07-30
Lazio,188,9,740,937,6829,863,8629,18,6193,2436,8629,341764,414397,2379,2020-07-30
Liguria,21,0,175,196,8448,1566,10210,13,8494,1716,10210,100167,187467,1595,2020-07-30
Toscana,17,0,372,389,8946,1134,10469,11,10236,233,10469,279879,421637,3330,2020-07-30
Veneto,31,3,857,891,17039,2073,20003,112,19385,618,20003,482840,1214358,12388,2020-07-30
Emilia-Romagna,65,4,1402,1471,23874,4289,29634,35,28339,1295,29634,390738,644350,10070,2020-07-30
Piemonte,124,5,661,790,26728,4128,31646,10,25317,6329,31646,304335,496601,3286,2020-07-30
PA Trento,0,0,101,101,4467,405,4973,3,3394,1579,4973,72141,151105,499,2020-07-30
Basilicata,2,0,45,47,374,28,449,0,402,47,449,46028,46818,278,2020-07-30
Lombardia,137,14,6574,6725,72429,16801,95955,34,89531,6424,95955,759439,1265549,3992,2020-07-27
Valle d'Aosta,1,0,0,1,1049,146,1196,0,1079,117,1196,15320,20977,102,2020-07-27
Calabria,3,0,75,78,1072,97,1247,0,1159,88,1247,114756,116790,200,2020-07-27
Sardegna,5,0,10,15,1236,135,1386,0,1364,22,1386,87773,103468,382,2020-07-27
Umbria,7,1,9,17,1368,80,1465,0,1444,21,1465,76311,117303,200,2020-07-27
PA Bolzano,7,0,87,94,2314,292,2700,2,2700,0,2700,52154,101707,394,2020-07-27
Sicilia,22,4,168,194,2719,283,3196,3,2777,419,3196,210021,264940,1278,2020-07-27
Abruzzo,13,1,100,114,2783,471,3368,9,3130,238,3368,82423,125155,-2199,2020-07-27
Friuli Venezia Giulia,8,2,102,112,2918,345,3375,0,3361,14,3375,122564,241291,867,2020-07-27
Molise,1,0,24,25,421,23,469,3,467,2,469,25868,27019,157,2020-07-27
Puglia,15,0,64,79,3962,551,4592,3,1985,2607,4592,158704,230475,1052,2020-07-27
PA Trento,1,0,93,94,4467,405,4966,1,3392,1574,4966,71334,148644,104,2020-07-27
Marche,5,0,107,112,5728,987,6827,2,6827,0,6827,97635,162840,287,2020-07-27
Lazio,193,9,742,944,6762,861,8567,13,6172,2395,8567,336276,407440,2655,2020-07-27
Liguria,29,1,180,210,8398,1566,10174,24,8484,1690,10174,97867,182797,1967,2020-07-27
Toscana,13,0,350,363,8944,1131,10438,8,10207,231,10438,273792,411665,1529,2020-07-27
Veneto,31,0,703,734,17027,2064,19825,16,19360,465,19825,474106,1182530,4812,2020-07-27
Emilia-Romagna,77,4,1375,1456,23814,4285,29555,33,28302,1253,29555,375850,617813,4828,2020-07-27
Piemonte,141,5,656,802,26681,4127,31610,4,25441,6169,31610,299026,487189,1116,2020-07-27
Campania,29,4,332,365,4127,434,4926,14,4858,68,4926,165961,324552,1555,2020-07-27
Basilicata,2,0,45,47,374,28,449,1,402,47,449,45189,45979,273,2020-07-27
Lombardia,139,13,6619,6771,72349,16801,95921,74,89521,6400,95921,756888,1261557,8057,2020-07-26
Valle d'Aosta,1,0,0,1,1049,146,1196,0,1079,117,1196,15254,20875,99,2020-07-26
Calabria,3,0,76,79,1071,97,1247,0,1159,88,1247,114556,116590,871,2020-07-26
Sardegna,6,0,13,19,1235,134,1388,0,1364,24,1388,87413,103086,337,2020-07-26
Umbria,7,0,10,17,1368,80,1465,0,1444,21,1465,76185,117103,507,2020-07-26
PA Bolzano,7,0,85,92,2314,292,2698,5,2698,0,2698,51844,101313,1002,2020-07-26
Sicilia,20,2,173,195,2715,283,3193,14,2776,417,3193,209196,263662,1508,2020-07-26
Abruzzo,13,2,97,112,2777,470,3359,1,3129,230,3359,83616,127354,3358,2020-07-26
Friuli Venezia Giulia,9,2,94,105,2925,345,3375,2,3361,14,3375,122167,240424,852,2020-07-26
Molise,1,0,21,22,421,23,466,3,464,2,466,25741,26862,113,2020-07-26
Puglia,15,0,63,78,3961,550,4589,3,1984,2605,4589,157669,229423,1890,2020-07-26
PA Trento,1,0,92,93,4467,405,4965,6,3391,1574,4965,71268,148540,1122,2020-07-26
Marche,3,1,118,122,5716,987,6825,7,6825,0,6825,97446,162553,938,2020-07-26
Lazio,189,9,737,935,6759,860,8554,19,6163,2391,8554,334242,404785,2773,2020-07-26
Liguria,29,1,173,203,8381,1566,10150,3,8466,1684,10150,96890,180830,1083,2020-07-26
Toscana,13,0,342,355,8944,1131,10430,15,10201,229,10430,272875,410136,2941,2020-07-26
Veneto,31,1,690,722,17023,2064,19809,19,19356,453,19809,472962,1177718,6923,2020-07-26
Emilia-Romagna,75,4,1365,1444,23793,4285,29522,61,28290,1232,29522,367597,612985,3140,2020-07-26
Piemonte,143,5,654,802,26678,4126,31606,12,25461,6145,31606,298776,486073,2309,2020-07-26
Campania,28,4,320,352,4126,434,4912,11,4848,64,4912,165489,322997,703,2020-07-26
Basilicata,2,0,44,46,374,28,448,0,402,46,448,44921,45706,0,2020-07-26
Lombardia,148,7,5856,6011,73402,16806,96219,77,89624,6595,96219,782147,1300088,8348,2020-07-31
Valle d'Aosta,1,0,11,12,1050,146,1208,0,1090,118,1208,15574,21532,124,2020-07-31
Calabria,3,1,93,97,1072,97,1266,4,1159,107,1266,118634,120668,958,2020-07-31
Sardegna,3,0,30,33,1237,134,1404,10,1365,39,1404,90445,106345,644,2020-07-31
Umbria,6,0,12,18,1368,80,1466,1,1445,21,1466,78170,120896,697,2020-07-31
PA Bolzano,6,1,95,102,2323,292,2717,15,2717,0,2717,54206,105217,1109,2020-07-31
Sicilia,38,2,235,275,2730,283,3288,16,2809,479,3288,217405,276773,2485,2020-07-31
Abruzzo,13,1,97,111,2799,472,3382,5,3138,244,3382,84411,128483,1066,2020-07-31
Friuli Venezia Giulia,9,2,111,122,2927,345,3394,3,3377,17,3394,125634,251621,2530,2020-07-31
Molise,1,0,26,27,421,23,471,1,469,2,471,26528,27679,144,2020-07-31
Puglia,18,0,77,95,3964,552,4611,2,1991,2620,4611,165237,240004,1862,2020-07-31
Campania,48,6,341,395,4169,435,4999,9,4923,76,4999,170810,332836,2973,2020-07-31
Marche,6,0,141,147,5750,987,6884,21,6884,0,6884,100200,167216,982,2020-07-31
Lazio,183,9,753,945,6839,863,8647,18,6197,2450,8647,343670,416921,2524,2020-07-31
Liguria,19,0,181,200,8447,1567,10214,4,8468,1746,10214,100861,189022,1555,2020-07-31
Toscana,17,0,370,387,8962,1134,10483,14,10250,233,10483,281692,424574,2937,2020-07-31
Veneto,33,3,964,1000,17046,2074,20120,117,19407,713,20120,485614,1228415,14057,2020-07-31
Emilia-Romagna,59,4,1433,1496,23885,4289,29670,36,28354,1316,29670,395936,662830,18480,2020-07-31
Piemonte,103,5,691,799,26739,4129,31667,21,25281,6386,31667,305619,499126,2525,2020-07-31
PA Trento,0,0,100,100,4470,405,4975,2,3394,1581,4975,72464,153167,2062,2020-07-31
Basilicata,2,0,48,50,374,28,452,3,402,50,452,46410,47200,382,2020-07-31
Lombardia,154,13,6396,6563,72689,16802,96054,46,89567,6487,96054,768509,1280533,8658,2020-07-29
Valle d'Aosta,1,0,12,13,1049,146,1208,2,1090,118,1208,15465,21287,111,2020-07-29
Calabria,3,0,83,86,1072,97,1255,3,1159,96,1255,116558,118592,886,2020-07-29
Sardegna,3,0,20,23,1237,134,1394,2,1365,29,1394,89000,105003,802,2020-07-29
Umbria,7,1,9,17,1368,80,1465,0,1444,21,1465,77327,119259,890,2020-07-29
PA Bolzano,6,1,79,86,2318,292,2696,5,2696,0,2696,52913,103004,909,2020-07-29
Sicilia,29,2,193,224,2726,283,3233,18,2787,446,3233,213928,271097,3135,2020-07-29
Abruzzo,14,1,94,109,2792,472,3373,4,3135,238,3373,83195,126445,903,2020-07-29
Friuli Venezia Giulia,8,2,102,112,2921,345,3378,3,3364,14,3378,124140,246256,2363,2020-07-29
Molise,1,0,25,26,421,23,470,1,468,2,470,26232,27383,215,2020-07-29
Puglia,17,0,75,92,3963,551,4606,10,1988,2618,4606,162238,235701,2454,2020-07-29
Campania,26,1,381,408,4132,434,4974,19,4898,76,4974,168298,327787,1689,2020-07-29
Marche,5,0,125,130,5738,987,6855,17,6855,0,6855,98940,165056,1188,2020-07-29
Lazio,198,9,762,969,6780,862,8611,34,6187,2424,8611,339954,412018,2829,2020-07-29
Liguria,21,0,176,197,8434,1566,10197,20,8482,1715,10197,99364,185872,1694,2020-07-29
Toscana,15,0,365,380,8944,1134,10458,17,10225,233,10458,277889,418307,3843,2020-07-29
Veneto,31,0,753,784,17034,2073,19891,42,19379,512,19891,479840,1201970,10445,2020-07-29
Emilia-Romagna,66,3,1382,1451,23865,4287,29603,28,28328,1275,29603,384747,634280,8318,2020-07-29
Piemonte,124,5,672,801,26707,4128,31636,14,25356,6280,31636,302380,493315,2921,2020-07-29
PA Trento,0,0,98,98,4467,405,4970,4,3394,1576,4970,71918,150606,1507,2020-07-29
Basilicata,2,0,45,47,374,28,449,0,402,47,449,45750,46540,258,2020-07-29
Lombardia,151,13,6514,6678,72528,16802,96008,53,89560,6448,96008,763406,1271875,6326,2020-07-28
Valle d'Aosta,1,0,10,11,1049,146,1206,10,1088,118,1206,15399,21176,199,2020-07-28
Calabria,3,0,80,83,1072,97,1252,5,1159,93,1252,115672,117706,916,2020-07-28
Sardegna,5,0,16,21,1237,134,1392,6,1365,27,1392,88391,104201,733,2020-07-28
Umbria,7,1,9,17,1368,80,1465,0,1444,21,1465,76851,118369,1066,2020-07-28
PA Bolzano,7,0,78,85,2315,292,2692,2,2692,0,2692,52364,102095,388,2020-07-28
Sicilia,29,2,175,206,2726,283,3215,19,2782,433,3215,211860,267962,3022,2020-07-28
Abruzzo,14,1,92,107,2790,472,3369,1,3131,238,3369,82644,125542,387,2020-07-28
Friuli Venezia Giulia,7,2,103,112,2918,345,3375,0,3361,14,3375,123405,243893,2602,2020-07-28
Molise,1,0,24,25,421,23,469,0,467,2,469,26017,27168,149,2020-07-28
Puglia,15,0,67,82,3963,551,4596,4,1985,2611,4596,160386,233247,2772,2020-07-28
PA Trento,1,0,93,94,4467,405,4966,0,3392,1574,4966,71558,149099,455,2020-07-28
Marche,4,0,116,120,5731,987,6838,11,6838,0,6838,98242,163868,1028,2020-07-28
Lazio,194,9,739,942,6773,862,8577,10,6175,2402,8577,337657,409189,1749,2020-07-28
Liguria,27,0,182,209,8402,1566,10177,3,8463,1714,10177,98525,184178,1381,2020-07-28
Toscana,13,0,350,363,8944,1134,10441,3,10210,231,10441,275553,414464,2799,2020-07-28
Veneto,33,0,721,754,17026,2069,19849,24,19368,481,19849,476975,1191525,8995,2020-07-28
Emilia-Romagna,72,3,1384,1459,23830,4286,29575,20,28310,1265,29575,379540,625962,8149,2020-07-28
Piemonte,136,5,660,801,26694,4127,31622,12,25398,6224,31622,300716,490394,3205,2020-07-28
Campania,27,4,362,393,4128,434,4955,29,4883,72,4955,167057,326098,1546,2020-07-28
Basilicata,2,0,45,47,374,28,449,0,402,47,449,45492,46282,303,2020-07-28
Lombardia,148,13,6614,6775,72271,16801,95847,79,89482,6365,95847,752200,1253500,10725,2020-07-25
Valle d'Aosta,1,0,0,1,1049,146,1196,0,1079,117,1196,15193,20776,31,2020-07-25
Calabria,3,0,76,79,1071,97,1247,1,1159,88,1247,113685,115719,949,2020-07-25
Sardegna,6,0,13,19,1235,134,1388,3,1364,24,1388,87120,102749,764,2020-07-25
Umbria,7,0,10,17,1368,80,1465,0,1444,21,1465,75819,116596,855,2020-07-25
PA Bolzano,6,0,81,87,2314,292,2693,6,2693,0,2693,51322,100311,960,2020-07-25
Sicilia,15,2,164,181,2715,283,3179,13,2770,409,3179,208167,262154,2208,2020-07-25
Abruzzo,11,2,99,112,2777,470,3359,3,3130,229,3359,81641,123996,796,2020-07-25
Friuli Venezia Giulia,8,2,93,103,2925,345,3373,5,3359,14,3373,121861,239572,2201,2020-07-25
Molise,0,0,21,21,419,23,463,3,461,2,463,25598,26749,160,2020-07-25
Puglia,16,0,60,76,3961,549,4586,8,1984,2602,4586,156395,227533,1843,2020-07-25
PA Trento,2,0,86,88,4466,405,4959,2,3391,1568,4959,70932,147418,1466,2020-07-25
Marche,3,1,125,129,5702,987,6818,2,6818,0,6818,96918,161615,1023,2020-07-25
Lazio,186,9,733,928,6749,858,8535,19,6162,2373,8535,331790,402012,2882,2020-07-25
Liguria,27,0,173,200,8381,1566,10147,3,8463,1684,10147,96298,179747,1132,2020-07-25
Toscana,13,0,330,343,8941,1131,10415,10,10186,229,10415,271049,407195,2846,2020-07-25
Veneto,30,1,674,705,17021,2064,19790,31,19355,435,19790,471262,1170795,9341,2020-07-25
Emilia-Romagna,78,4,1317,1399,23778,4284,29461,49,28269,1192,29461,364681,609845,6557,2020-07-25
Piemonte,141,5,646,792,26677,4125,31594,16,25540,6054,31594,297089,483764,2138,2020-07-25
Campania,28,2,311,341,4126,434,4901,21,4837,64,4901,163877,322294,2434,2020-07-25
Basilicata,2,0,44,46,374,28,448,1,402,46,448,44921,45706,360,2020-07-25
Lombardia,144,17,6598,6759,72208,16801,95768,53,89450,6318,95768,746025,1242775,9860,2020-07-24
Valle d'Aosta,1,0,0,1,1049,146,1196,0,1079,117,1196,15168,20745,77,2020-07-24
Calabria,3,0,75,78,1071,97,1246,1,1159,87,1246,112736,114770,979,2020-07-24
Sardegna,7,0,9,16,1235,134,1385,3,1364,21,1385,86544,101985,754,2020-07-24
Umbria,7,0,12,19,1366,80,1465,2,1444,21,1465,75407,115741,682,2020-07-24
PA Bolzano,6,0,77,83,2312,292,2687,1,2687,0,2687,50667,99351,1173,2020-07-24
Sicilia,11,2,157,170,2713,283,3166,8,2765,401,3166,206743,259946,1975,2020-07-24
Abruzzo,11,2,100,113,2773,470,3356,4,3129,227,3356,81191,123200,897,2020-07-24
Friuli Venezia Giulia,9,2,87,98,2925,345,3368,5,3354,14,3368,121040,237371,2783,2020-07-24
Molise,0,0,18,18,419,23,460,1,458,2,460,25438,26589,255,2020-07-24
Puglia,11,0,56,67,3962,549,4578,13,1991,2587,4578,155202,225690,1901,2020-07-24
PA Trento,2,0,85,87,4465,405,4957,16,3390,1567,4957,70520,145952,1675,2020-07-24
Marche,2,1,129,132,5697,987,6816,1,6816,0,6816,96414,160592,1116,2020-07-24
Lazio,184,9,723,916,6743,857,8516,18,6155,2361,8516,329353,399130,2075,2020-07-24
Liguria,26,0,172,198,8380,1566,10144,5,8479,1665,10144,95636,178615,1337,2020-07-24
Toscana,14,0,321,335,8939,1131,10405,11,10176,229,10405,269409,404349,2870,2020-07-24
Veneto,30,2,653,685,17011,2063,19759,30,19349,410,19759,468576,1161454,12370,2020-07-24
Emilia-Romagna,79,4,1289,1372,23758,4283,29413,63,28253,1160,29413,361148,603288,5999,2020-07-24
Piemonte,147,5,624,776,26679,4123,31578,11,25578,6000,31578,295873,481626,2744,2020-07-24
Campania,17,2,313,332,4114,434,4880,6,4816,64,4880,162108,319860,1557,2020-07-24
Basilicata,2,0,44,46,373,28,447,0,402,45,447,44561,45346,255,2020-07-24
Lombardia,139,17,6785,6941,71973,16801,95715,82,89426,6289,95715,740405,1232915,15086,2020-07-23
Valle d'Aosta,1,0,0,1,1049,146,1196,0,1079,117,1196,15131,20668,129,2020-07-23
Calabria,3,0,74,77,1071,97,1245,2,1159,86,1245,111757,113791,1142,2020-07-23
Sardegna,7,0,7,14,1234,134,1382,2,1364,18,1382,85852,101231,1091,2020-07-23
Umbria,6,0,11,17,1366,80,1463,2,1443,20,1463,75059,115059,904,2020-07-23
PA Bolzano,6,0,83,89,2305,292,2686,1,2686,0,2686,49882,98178,539,2020-07-23
Sicilia,10,3,150,163,2712,283,3158,5,2762,396,3158,205508,257971,2819,2020-07-23
Abruzzo,8,2,105,115,2767,470,3352,10,3125,227,3352,80636,122303,1336,2020-07-23
Friuli Venezia Giulia,7,1,89,97,2921,345,3363,3,3349,14,3363,120339,234588,2489,2020-07-23
Molise,0,0,17,17,419,23,459,9,457,2,459,25185,26334,308,2020-07-23
Puglia,11,0,53,64,3953,548,4565,9,2014,2551,4565,153199,223789,2458,2020-07-23
PA Trento,2,0,69,71,4465,405,4941,30,3389,1552,4941,70026,144277,1332,2020-07-23
Marche,2,1,134,137,5691,987,6815,1,6815,0,6815,95858,159476,1079,2020-07-23
Lazio,180,9,718,907,6735,856,8498,26,6148,2350,8498,327552,397055,2931,2020-07-23
Liguria,29,0,170,199,8374,1566,10139,15,8486,1653,10139,94903,177278,1927,2020-07-23
Toscana,14,1,313,328,8935,1131,10394,4,10166,228,10394,267719,401479,2786,2020-07-23
Veneto,28,2,627,657,17010,2062,19729,22,19340,389,19729,465433,1149084,10458,2020-07-23
Emilia-Romagna,79,6,1265,1350,23719,4281,29350,55,28235,1115,29350,357173,597289,5585,2020-07-23
Piemonte,144,6,635,785,26659,4123,31567,9,25624,5943,31567,294261,478882,3502,2020-07-23
Campania,35,1,293,329,4111,434,4874,16,4810,64,4874,160605,318303,2112,2020-07-23
Basilicata,2,0,44,46,373,28,447,3,402,45,447,44306,45091,298,2020-07-23
Lombardia,149,17,6809,6975,71860,16798,95633,51,89400,6233,95633,733150,1217829,5361,2020-07-22
Valle d'Aosta,1,0,0,1,1049,146,1196,0,1079,117,1196,15112,20539,159,2020-07-22
Calabria,3,0,72,75,1071,97,1243,4,1159,84,1243,110615,112649,1049,2020-07-22
Sardegna,7,0,5,12,1234,134,1380,1,1363,17,1380,84889,100140,664,2020-07-22
Umbria,6,0,10,16,1365,80,1461,2,1441,20,1461,74634,114155,1069,2020-07-22
PA Bolzano,6,0,90,96,2297,292,2685,0,2685,0,2685,49628,97639,799,2020-07-22
Sicilia,10,3,148,161,2709,283,3153,7,2758,395,3153,203459,255152,2675,2020-07-22
Abruzzo,8,1,100,109,2763,470,3342,0,3117,225,3342,79901,120967,740,2020-07-22
Friuli Venezia Giulia,8,0,90,98,2917,345,3360,2,3347,13,3360,119547,232099,2466,2020-07-22
Molise,1,0,10,11,416,23,450,4,444,6,450,24883,26026,118,2020-07-22
Puglia,11,0,45,56,3952,548,4556,0,2032,2524,4556,151624,221331,2421,2020-07-22
PA Trento,2,0,39,41,4465,405,4911,20,3389,1522,4911,69570,142945,1121,2020-07-22
Marche,2,1,137,140,5687,987,6814,1,6814,0,6814,95198,158397,1135,2020-07-22
Lazio,174,9,706,889,6728,855,8472,16,6131,2341,8472,324963,394124,3001,2020-07-22
Liguria,31,0,164,195,8364,1565,10124,7,8480,1644,10124,93807,175351,1646,2020-07-22
Toscana,12,1,319,332,8927,1131,10390,6,10162,228,10390,266008,398693,3632,2020-07-22
Veneto,35,2,606,643,17007,2057,19707,36,19338,369,19707,462452,1138626,8112,2020-07-22
Emilia-Romagna,81,7,1237,1325,23689,4281,29295,57,28212,1083,29295,352794,591704,7736,2020-07-22
Piemonte,146,6,637,789,26646,4123,31558,13,25673,5885,31558,292191,475380,3084,2020-07-22
Campania,29,1,285,315,4109,434,4858,19,4794,64,4858,159338,316191,2065,2020-07-22
Basilicata,2,0,41,43,373,28,444,36,402,42,444,44008,44793,265,2020-07-22
Lombardia,151,21,6838,7010,71775,16797,95582,34,89382,6200,95582,728169,1212468,5973,2020-07-21
Valle d'Aosta,1,0,0,1,1049,146,1196,0,1079,117,1196,15007,20380,110,2020-07-21
Calabria,3,0,68,71,1071,97,1239,0,1159,80,1239,109566,111600,943,2020-07-21
Sardegna,7,0,5,12,1233,134,1379,0,1363,16,1379,84157,99476,674,2020-07-21
Umbria,6,0,8,14,1365,80,1459,3,1439,20,1459,74180,113086,1118,2020-07-21
PA Bolzano,6,0,93,99,2294,292,2685,1,2685,0,2685,49079,96840,369,2020-07-21
Sicilia,10,2,145,157,2706,283,3146,2,2753,393,3146,201700,252477,2653,2020-07-21
Abruzzo,12,0,104,116,2758,470,3344,2,3119,225,3344,79463,120227,576,2020-07-21
Friuli Venezia Giulia,7,0,92,99,2914,345,3358,2,3346,12,3358,118838,229633,2614,2020-07-21
Molise,1,0,7,8,415,23,446,0,444,2,446,24768,25908,163,2020-07-21
Puglia,11,0,49,60,3948,548,4556,0,2049,2507,4556,149713,218910,2508,2020-07-21
PA Trento,1,0,21,22,4464,405,4891,2,3388,1503,4891,69272,141824,435,2020-07-21
Marche,2,1,141,144,5682,987,6813,2,6813,0,6813,94527,157262,1112,2020-07-21
Lazio,175,9,697,881,6722,853,8456,6,6128,2328,8456,322181,391123,1682,2020-07-21
Liguria,29,0,161,190,8362,1565,10117,12,8476,1641,10117,92795,173705,1454,2020-07-21
Toscana,11,1,314,326,8927,1131,10384,9,10157,227,10384,263474,395061,3063,2020-07-21
Veneto,35,2,587,624,16994,2053,19671,22,19335,336,19671,459776,1130514,7128,2020-07-21
Emilia-Romagna,85,6,1206,1297,23662,4279,29238,18,28196,1042,29238,349522,583968,5382,2020-07-21
Piemonte,144,6,663,813,26609,4123,31545,8,25744,5801,31545,290411,472296,3306,2020-07-21
Campania,33,1,263,297,4108,434,4839,6,4775,64,4839,158142,314126,1590,2020-07-21
Basilicata,2,0,5,7,373,28,408,0,402,6,408,43743,44528,257,2020-07-21
Lombardia,2013,184,35753,37950,88536,17159,143645,4916,119459,24186,143645,1655276,2647681,36963,2020-10-23
Valle d'Aosta,50,3,948,1001,1166,149,2316,97,2076,240,2316,23862,37111,440,2020-10-23
Calabria,100,9,1586,1695,1645,105,3445,159,1159,2286,3445,249135,251288,3110,2020-10-23
PA Bolzano,106,8,2468,2582,2940,296,5818,269,5818,0,5818,110930,213835,2824,2020-10-23
Umbria,183,21,3426,3630,2577,100,6307,447,2287,4020,6307,158186,269993,3595,2020-10-23
Sardegna,275,36,3975,4286,2768,181,7235,349,2902,4333,7235,205575,242374,3746,2020-10-23
Abruzzo,228,16,3285,3529,3293,503,7325,234,5743,1582,7325,162471,259623,3299,2020-10-23
Friuli Venezia Giulia,88,19,2370,2477,4569,369,7415,340,6792,623,7415,216003,497736,5301,2020-10-23
PA Trento,65,3,1061,1129,5974,423,7526,207,4280,3246,7526,110387,271097,3497,2020-10-23
Basilicata,54,4,849,907,621,42,1570,89,459,1111,1570,93187,94027,1434,2020-10-23
Marche,152,22,2875,3049,6596,1000,10645,453,10645,0,10645,173274,297179,4317,2020-10-23
Sicilia,593,89,8454,9136,5772,408,15316,730,9894,5422,15316,447704,630011,8015,2020-10-23
Liguria,598,33,4838,5469,14210,1680,21359,778,15062,6297,21359,209220,399461,5096,2020-10-23
Toscana,574,82,13718,14374,12290,1237,27901,1290,21997,5904,27901,653719,973655,11378,2020-10-23
Lazio,1354,135,18332,19821,10108,1081,31010,1389,12311,18699,31010,1021323,1249561,22457,2020-10-23
Campania,1090,98,23447,24635,9107,563,34305,2280,32025,2280,34305,571147,830767,15801,2020-10-23
Veneto,515,64,13455,14034,24798,2308,41140,1550,23734,17406,41140,860733,2208831,16277,2020-10-23
Emilia-Romagna,657,86,11771,12514,27304,4547,44365,888,35818,8547,44365,790989,1449195,15978,2020-10-23
Piemonte,1362,84,15016,16462,31002,4236,51700,2032,27151,24549,51700,547164,919629,12665,2020-10-23
Puglia,479,52,6297,6828,5926,646,13400,590,3724,9676,13400,364270,513235,5253,2020-10-23
Molise,13,1,480,494,606,26,1126,56,1078,48,1126,54552,58164,586,2020-10-23
Lombardia,2153,213,40319,42685,88706,17210,148601,4956,122847,25754,148601,1675053,2680430,32749,2020-10-24
Valle d'Aosta,58,2,1033,1093,1183,152,2428,112,2177,251,2428,24087,37525,414,2020-10-24
Calabria,100,10,1739,1849,1657,105,3611,166,1162,2449,3611,252469,254634,3346,2020-10-24
PA Bolzano,133,12,2711,2856,2943,296,6095,277,6095,0,6095,112056,216044,2209,2020-10-24
Umbria,203,25,3793,4021,2709,102,6832,525,2412,4420,6832,160255,273906,3913,2020-10-24
Sardegna,287,36,4263,4586,2794,184,7564,329,3010,4554,7564,208859,246095,3721,2020-10-24
PA Trento,59,4,1193,1256,6008,424,7688,162,4351,3337,7688,110914,273190,2093,2020-10-24
Abruzzo,228,18,3496,3742,3455,503,7700,375,6058,1642,7700,164810,263485,3862,2020-10-24
Friuli Venezia Giulia,100,16,2660,2776,4679,372,7827,412,7112,715,7827,218014,504257,6521,2020-10-24
Basilicata,53,5,887,945,630,44,1619,50,459,1160,1619,94401,95241,1214,2020-10-24
Marche,178,23,3098,3299,6619,1001,10919,274,10919,0,10919,174895,299892,2713,2020-10-24
Sicilia,606,90,9193,9889,5896,417,16202,886,10410,5792,16202,452738,637158,7147,2020-10-24
Liguria,641,38,5081,5760,14948,1686,22394,1035,15958,6436,22394,212171,405575,6114,2020-10-24
Toscana,640,87,14961,15688,12491,1248,29427,1526,23194,6233,29427,662605,987024,13369,2020-10-24
Lazio,1438,141,19826,21405,10202,1090,32697,1687,12775,19922,32697,1041123,1272340,22779,2020-10-24
Campania,1118,108,25077,26303,9149,571,36023,1718,33707,2316,36023,579568,843297,12530,2020-10-24
Veneto,548,68,15005,15621,24931,2317,42869,1729,23881,18988,42869,866907,2226292,17461,2020-10-24
Emilia-Romagna,723,89,12830,13642,27343,4557,45542,1180,36378,9164,45542,799074,1466807,17612,2020-10-24
Piemonte,1483,88,16272,17843,31157,4248,53248,1548,27787,25461,53248,556121,931476,11847,2020-10-24
Puglia,522,53,6823,7398,5977,656,14031,631,3933,10098,14031,367410,518574,5339,2020-10-24
Molise,16,2,507,525,640,27,1192,66,1143,49,1192,55250,58880,716,2020-10-24
Lombardia,2326,231,45426,47983,89145,17235,154363,5762,127457,26906,154363,1698094,2715715,35285,2020-10-25
Piemonte,1601,94,18182,19877,31399,4259,55535,2287,28556,26979,55535,566796,944133,12657,2020-10-25
Emilia-Romagna,757,88,13983,14828,27345,4561,46734,1192,36934,9800,46734,804679,1476451,9644,2020-10-25
Veneto,585,71,16316,16972,25036,2329,44337,1468,24005,20332,44337,871568,2238353,12061,2020-10-25
Campania,1151,113,27456,28720,9322,571,38613,2590,36250,2363,38613,587003,860203,16906,2020-10-25
Lazio,1476,146,21193,22815,10323,1100,34238,1541,13165,21073,34238,1057293,1294172,21832,2020-10-25
Toscana,714,111,16495,17320,12708,1262,31290,1863,24763,6527,31290,671386,1000835,13811,2020-10-25
Liguria,696,41,5299,6036,15324,1691,23051,657,16455,6596,23051,214109,409770,4195,2020-10-25
Sicilia,642,95,9818,10555,5914,428,16897,695,10855,6042,16897,456572,642351,5193,2020-10-25
Puglia,548,57,7267,7872,6011,663,14546,515,4146,10400,14546,370561,522951,4377,2020-10-25
Marche,178,23,3525,3726,6711,1003,11440,521,11440,0,11440,177287,303279,3387,2020-10-25
Friuli Venezia Giulia,112,23,2892,3027,4760,374,8161,334,7375,786,8161,219485,508057,3800,2020-10-25
Abruzzo,245,18,3822,4085,3469,514,8068,368,6422,1646,8068,166730,266853,3368,2020-10-25
PA Trento,72,4,1256,1332,6035,425,7792,104,4414,3378,7792,111246,275017,1827,2020-10-25
Sardegna,299,34,4421,4754,2814,191,7759,195,3038,4721,7759,211113,248525,2430,2020-10-25
Umbria,215,29,4151,4395,2795,105,7295,463,2575,4720,7295,162084,277303,3397,2020-10-25
PA Bolzano,147,11,3029,3187,2951,296,6434,339,6434,0,6434,113387,218797,2753,2020-10-25
Calabria,106,10,1897,2013,1671,106,3790,179,1162,2628,3790,255683,257594,2960,2020-10-25
Valle d'Aosta,63,2,1116,1181,1191,153,2525,97,2265,260,2525,24256,37826,301,2020-10-25
Basilicata,53,5,955,1013,639,44,1696,77,479,1217,1696,95573,96422,1181,2020-10-25
Molise,20,2,528,550,640,28,1218,26,1169,49,1218,55751,59395,515,2020-10-25
Lombardia,2459,242,47624,50325,90356,17252,157933,3570,129608,28325,157933,1711397,2737039,21324,2020-10-26
Valle d'Aosta,75,2,1239,1316,1199,154,2669,144,2388,281,2669,24533,38331,505,2020-10-26
Calabria,108,9,2067,2184,1678,108,3970,180,1162,2808,3970,258151,260121,2527,2020-10-26
PA Bolzano,152,12,3337,3501,2955,299,6755,321,6755,0,6755,114559,221307,2510,2020-10-26
Umbria,239,31,4313,4583,2867,108,7558,263,2638,4920,7558,162797,278289,986,2020-10-26
PA Trento,81,5,1354,1440,6039,426,7905,113,4470,3435,7905,111484,276004,987,2020-10-26
Sardegna,303,35,4582,4920,2878,192,7990,231,3113,4877,7990,213063,250901,2376,2020-10-26
Abruzzo,249,21,4083,4353,3537,524,8414,348,6549,1865,8414,168842,270057,3204,2020-10-26
Friuli Venezia Giulia,119,27,3139,3285,4833,377,8495,334,7686,809,8495,220578,511144,3087,2020-10-26
Basilicata,66,6,937,1009,651,44,1704,8,485,1219,1704,95707,96556,134,2020-10-26
Marche,227,26,3669,3922,6752,1004,11678,238,11678,0,11678,178313,304340,1061,2020-10-26
Sicilia,677,98,10170,10945,6081,439,17465,568,11173,6292,17465,459725,647327,4976,2020-10-26
Liguria,788,46,5608,6442,15324,1704,23470,419,16837,6633,23470,215143,412289,2519,2020-10-26
Toscana,779,110,18487,19376,12810,1275,33461,2171,26539,6922,33461,680058,1013957,13122,2020-10-26
Lazio,1599,158,22649,24406,10414,1116,35936,1698,13424,22512,35936,1071581,1313163,18991,2020-10-26
Campania,1191,123,29361,30675,9332,587,40594,1981,38178,2416,40594,594439,871772,11569,2020-10-26
Veneto,612,76,17359,18047,25087,2332,45466,1129,24066,21400,45466,874701,2246098,7745,2020-10-26
Emilia-Romagna,816,93,14860,15769,27544,4564,47877,1146,37412,10465,47877,811249,1488534,12083,2020-10-26
Piemonte,1849,102,19316,21267,31620,4273,57160,1625,29063,28097,57160,574505,955500,11367,2020-10-26
Puglia,589,59,7631,8279,6018,673,14970,424,4289,10681,14970,372347,526008,3057,2020-10-26
Molise,19,3,618,640,651,28,1319,101,1270,49,1319,56300,59951,556,2020-10-26
Lombardia,151,21,6969,7141,71611,16796,95548,56,89367,6181,95548,724365,1206495,4288,2020-07-20
Valle d'Aosta,1,0,0,1,1049,146,1196,0,1079,117,1196,14947,20270,80,2020-07-20
Calabria,3,0,68,71,1071,97,1239,0,1159,80,1239,108623,110657,172,2020-07-20
Sardegna,7,0,5,12,1233,134,1379,0,1363,16,1379,83626,98802,552,2020-07-20
Umbria,6,0,6,12,1364,80,1456,0,1437,19,1456,73653,111968,196,2020-07-20
PA Bolzano,6,0,94,100,2292,292,2684,0,2684,0,2684,48867,96471,341,2020-07-20
Sicilia,10,2,145,157,2704,283,3144,2,2753,391,3144,200038,249824,973,2020-07-20
Abruzzo,13,0,108,121,2753,468,3342,6,3117,225,3342,79070,119651,147,2020-07-20
Friuli Venezia Giulia,7,0,92,99,2912,345,3356,4,3346,10,3356,118033,227019,832,2020-07-20
Molise,1,0,7,8,415,23,446,0,444,2,446,24605,25745,68,2020-07-20
Puglia,14,0,65,79,3930,548,4557,0,2054,2503,4557,147702,216402,753,2020-07-20
PA Trento,1,0,19,20,4464,405,4889,4,3387,1502,4889,69051,141389,512,2020-07-20
Marche,2,1,143,146,5678,987,6811,0,6811,0,6811,93877,156150,299,2020-07-20
Lazio,175,9,701,885,6714,851,8450,14,6128,2322,8450,321110,389441,2328,2020-07-20
Liguria,28,0,157,185,8355,1565,10105,12,8467,1638,10105,91898,172251,638,2020-07-20
Toscana,10,0,314,324,8921,1130,10375,1,10148,227,10375,261958,391998,1322,2020-07-20
Veneto,35,2,572,609,16990,2050,19649,42,19317,332,19649,457249,1123386,6118,2020-07-20
Emilia-Romagna,91,6,1201,1298,23645,4277,29220,42,28190,1030,29220,346535,578586,2302,2020-07-20
Piemonte,150,6,677,833,26584,4120,31537,1,25790,5747,31537,288837,468990,1805,2020-07-20
Campania,32,0,264,296,4104,433,4833,6,4769,64,4833,157038,312536,276,2020-07-20
Basilicata,2,0,5,7,373,28,408,0,402,6,408,43486,44271,251,2020-07-20
Lombardia,148,22,7070,7240,71464,16788,95492,33,89336,6156,95492,721640,1202207,7039,2020-07-19
Valle d'Aosta,2,0,1,3,1047,146,1196,0,1079,117,1196,14892,20190,86,2020-07-19
Calabria,4,0,68,72,1070,97,1239,1,1159,80,1239,108451,110485,830,2020-07-19
Sardegna,7,0,5,12,1233,134,1379,1,1363,16,1379,83144,98250,443,2020-07-19
Umbria,6,0,6,12,1364,80,1456,0,1437,19,1456,73521,111772,727,2020-07-19
PA Bolzano,6,0,95,101,2291,292,2684,1,2684,0,2684,48617,96130,631,2020-07-19
Sicilia,11,1,150,162,2697,283,3142,2,2753,389,3142,199333,248851,1472,2020-07-19
Abruzzo,14,0,103,117,2751,468,3336,1,3113,223,3336,78949,119504,759,2020-07-19
Friuli Venezia Giulia,7,0,89,96,2911,345,3352,2,3345,7,3352,117551,226187,1331,2020-07-19
Molise,1,0,7,8,415,23,446,0,444,2,446,24537,25677,91,2020-07-19
Puglia,14,0,65,79,3930,548,4557,7,2056,2501,4557,146774,215649,1776,2020-07-19
PA Trento,0,0,16,16,4464,405,4885,1,3385,1500,4885,68907,140877,594,2020-07-19
Marche,2,1,147,150,5674,987,6811,0,6811,0,6811,93692,155851,964,2020-07-19
Lazio,180,9,683,872,6713,851,8436,17,6121,2315,8436,318945,387113,3059,2020-07-19
Liguria,27,0,177,204,8324,1565,10093,23,8469,1624,10093,91468,171613,963,2020-07-19
Toscana,12,0,313,325,8920,1129,10374,16,10147,227,10374,261174,390676,2791,2020-07-19
Veneto,33,2,532,567,16990,2050,19607,48,19315,292,19607,455992,1117268,6171,2020-07-19
Emilia-Romagna,81,8,1177,1266,23638,4274,29178,51,28175,1003,29178,344582,576284,2730,2020-07-19
Piemonte,152,6,679,837,26580,4119,31536,3,25823,5713,31536,288174,467185,1659,2020-07-19
Campania,34,0,260,294,4100,433,4827,9,4763,64,4827,156869,312260,1409,2020-07-19
Basilicata,2,0,5,7,373,28,408,3,402,6,408,43235,44020,0,2020-07-19
Lombardia,149,22,7084,7255,71416,16788,95459,88,89332,6127,95459,717516,1195168,9054,2020-07-18
Valle d'Aosta,2,0,0,2,1048,146,1196,0,1079,117,1196,14826,20104,81,2020-07-18
Calabria,5,0,70,75,1066,97,1238,7,1159,79,1238,107621,109655,944,2020-07-18
Sardegna,7,0,4,11,1233,134,1378,1,1363,15,1378,82738,97807,749,2020-07-18
Umbria,6,0,8,14,1362,80,1456,2,1437,19,1456,73180,111045,931,2020-07-18
PA Bolzano,6,0,95,101,2290,292,2683,1,2683,0,2683,48340,95499,923,2020-07-18
Sicilia,14,0,148,162,2695,283,3140,4,2753,387,3140,198568,247379,1942,2020-07-18
Abruzzo,15,0,102,117,2750,468,3335,1,3113,222,3335,78469,118745,965,2020-07-18
Friuli Venezia Giulia,7,0,92,99,2906,345,3350,4,3343,7,3350,117057,224856,2078,2020-07-18
Molise,1,0,7,8,415,23,446,0,444,2,446,24446,25586,205,2020-07-18
Puglia,14,0,58,72,3930,548,4550,3,2054,2496,4550,145802,213873,2030,2020-07-18
PA Trento,0,0,19,19,4460,405,4884,3,3384,1500,4884,68722,140283,1363,2020-07-18
Marche,2,1,152,155,5670,987,6812,3,6812,0,6812,93195,154887,1008,2020-07-18
Lazio,174,9,683,866,6703,850,8419,20,6115,2304,8419,316173,384054,3015,2020-07-18
Liguria,28,0,172,200,8305,1565,10070,18,8462,1608,10070,90954,170650,1464,2020-07-18
Toscana,12,1,301,314,8915,1129,10358,2,10132,226,10358,259442,387885,3059,2020-07-18
Veneto,33,2,490,525,16985,2049,19559,34,19307,252,19559,454065,1111097,9132,2020-07-18
Emilia-Romagna,85,8,1141,1234,23619,4274,29127,40,28166,961,29127,342592,573554,4775,2020-07-18
Piemonte,150,6,691,847,26567,4119,31533,3,25844,5689,31533,287012,465526,2663,2020-07-18
Campania,44,1,242,287,4098,433,4818,15,4754,64,4818,155873,310851,1561,2020-07-18
Basilicata,3,0,2,5,373,27,405,0,402,3,405,43235,44020,323,2020-07-18
Lombardia,159,22,7240,7421,71172,16778,95371,55,89280,6091,95371,712261,1186114,9911,2020-07-17
Valle d'Aosta,2,0,0,2,1048,146,1196,0,1079,117,1196,14770,20023,108,2020-07-17
Calabria,6,0,63,69,1065,97,1231,5,1159,72,1231,106677,108711,859,2020-07-17
Sardegna,5,0,5,10,1233,134,1377,0,1362,15,1377,82095,97058,1076,2020-07-17
Umbria,6,0,6,12,1362,80,1454,2,1436,18,1454,72708,110114,837,2020-07-17
PA Bolzano,6,0,95,101,2289,292,2682,4,2682,0,2682,47745,94576,806,2020-07-17
Sicilia,9,0,149,158,2695,283,3136,4,2753,383,3136,197335,245437,2400,2020-07-17
Abruzzo,17,0,102,119,2747,468,3334,1,3116,218,3334,77893,117780,753,2020-07-17
Friuli Venezia Giulia,7,0,89,96,2905,345,3346,3,3339,7,3346,116622,222778,2835,2020-07-17
Molise,1,0,7,8,415,23,446,0,444,2,446,24242,25381,163,2020-07-17
Puglia,12,0,58,70,3929,548,4547,5,2053,2494,4547,144093,211843,1719,2020-07-17
PA Trento,0,0,16,16,4460,405,4881,0,3381,1500,4881,68352,138920,1319,2020-07-17
Marche,3,1,151,155,5667,987,6809,3,6809,0,6809,92653,153879,1031,2020-07-17
Lazio,175,9,668,852,6698,849,8399,14,6105,2294,8399,313544,381039,3103,2020-07-17
Liguria,29,0,157,186,8301,1565,10052,2,8447,1605,10052,90102,169186,1509,2020-07-17
Toscana,12,1,305,318,8909,1129,10356,6,10130,226,10356,257616,384826,2666,2020-07-17
Veneto,33,2,467,502,16976,2047,19525,55,19301,224,19525,451085,1101965,9272,2020-07-17
Emilia-Romagna,87,8,1133,1228,23586,4273,29087,54,28151,936,29087,339384,568779,5554,2020-07-17
Piemonte,150,6,700,856,26555,4119,31530,8,25904,5626,31530,285503,462863,2844,2020-07-17
Campania,49,1,222,272,4098,433,4803,12,4739,64,4803,154665,309290,1705,2020-07-17
Basilicata,3,0,2,5,373,27,405,0,402,3,405,42912,43697,297,2020-07-17
Lombardia,164,23,7322,7509,71032,16775,95316,80,89270,6046,95316,706440,1176203,10727,2020-07-16
Valle d'Aosta,1,0,1,2,1048,146,1196,0,1079,117,1196,14736,19915,91,2020-07-16
Calabria,5,0,60,65,1064,97,1226,8,1159,67,1226,105818,107852,897,2020-07-16
Sardegna,4,0,7,11,1232,134,1377,1,1362,15,1377,81230,95982,807,2020-07-16
Umbria,5,0,5,10,1362,80,1452,0,1435,17,1452,72335,109277,847,2020-07-16
PA Bolzano,6,0,94,100,2286,292,2678,1,2678,0,2678,47161,93770,767,2020-07-16
Sicilia,6,0,148,154,2695,283,3132,17,2753,379,3132,195812,243037,2295,2020-07-16
Abruzzo,17,0,103,120,2745,468,3333,2,3115,218,3333,77425,117027,774,2020-07-16
Friuli Venezia Giulia,7,0,90,97,2901,345,3343,4,3336,7,3343,116013,219943,2567,2020-07-16
Molise,1,0,8,9,414,23,446,0,444,2,446,24081,25218,181,2020-07-16
Puglia,11,0,57,68,3926,548,4542,1,2051,2491,4542,142396,210124,2711,2020-07-16
PA Trento,1,0,17,18,4458,405,4881,0,3381,1500,4881,68068,137601,1605,2020-07-16
Marche,3,1,152,156,5663,987,6806,1,6806,0,6806,92199,152848,1220,2020-07-16
Lazio,175,9,666,850,6687,848,8385,9,6100,2285,8385,310829,377936,2572,2020-07-16
Liguria,28,0,173,201,8285,1564,10050,8,8448,1602,10050,89337,167677,1464,2020-07-16
Toscana,12,2,301,315,8908,1127,10350,12,10125,225,10350,255850,382160,2964,2020-07-16
Veneto,31,2,422,455,16968,2047,19470,29,19297,173,19470,447878,1092693,8882,2020-07-16
Emilia-Romagna,88,9,1101,1198,23566,4271,29035,46,28128,907,29035,336154,563225,4459,2020-07-16
Piemonte,159,6,703,868,26536,4118,31522,7,25982,5540,31522,283577,460019,3087,2020-07-16
Campania,23,1,238,262,4097,432,4791,4,4728,63,4791,153642,307585,1222,2020-07-16
Basilicata,3,0,2,5,373,27,405,0,402,3,405,42615,43400,293,2020-07-16
Lombardia,177,23,7335,7535,70936,16765,95236,63,89240,5996,95236,699935,1165476,10426,2020-07-15
Valle d'Aosta,1,0,1,2,1048,146,1196,0,1079,117,1196,14702,19824,117,2020-07-15
Calabria,5,0,54,59,1062,97,1218,2,1159,59,1218,104921,106955,779,2020-07-15
Sardegna,4,0,8,12,1230,134,1376,2,1361,15,1376,80552,95175,1123,2020-07-15
Umbria,5,0,5,10,1362,80,1452,2,1435,17,1452,71881,108430,1129,2020-07-15
PA Bolzano,6,0,91,97,2288,292,2677,3,2677,0,2677,46587,93003,959,2020-07-15
Sicilia,4,0,133,137,2695,283,3115,0,2753,362,3115,194142,240742,2040,2020-07-15
Abruzzo,17,0,107,124,2740,467,3331,3,3113,218,3331,76907,116253,809,2020-07-15
Friuli Venezia Giulia,5,0,88,93,2901,345,3339,1,3332,7,3339,115345,217376,2670,2020-07-15
Molise,1,0,8,9,414,23,446,0,444,2,446,23903,25037,162,2020-07-15
Puglia,10,0,58,68,3926,547,4541,0,2051,2490,4541,140603,207413,2496,2020-07-15
PA Trento,1,0,23,24,4452,405,4881,0,3381,1500,4881,67776,135996,1138,2020-07-15
Marche,3,1,153,157,5661,987,6805,0,6805,0,6805,91580,151628,1319,2020-07-15
Lazio,190,10,698,898,6631,847,8376,20,6096,2280,8376,308504,375364,2338,2020-07-15
Liguria,24,0,172,196,8285,1561,10042,4,8455,1587,10042,88611,166213,1474,2020-07-15
Toscana,9,3,301,313,8898,1127,10338,8,10114,224,10338,254060,379196,3451,2020-07-15
Veneto,30,2,406,438,16960,2043,19441,21,19289,152,19441,445120,1083811,7092,2020-07-15
Emilia-Romagna,88,9,1073,1170,23548,4271,28989,18,28112,877,28989,333415,558766,3985,2020-07-15
Piemonte,163,8,716,887,26510,4118,31515,8,26053,5462,31515,281745,456932,2840,2020-07-15
Campania,51,1,207,259,4096,432,4787,8,4724,63,4787,152896,306363,1846,2020-07-15
Basilicata,3,0,2,5,373,27,405,0,402,3,405,42322,43107,256,2020-07-15
Lombardia,176,27,7749,7952,70461,16760,95173,30,89200,5973,95173,693556,1155050,5636,2020-07-14
Valle d'Aosta,3,0,1,4,1046,146,1196,0,1079,117,1196,14621,19707,108,2020-07-14
Calabria,5,0,52,57,1062,97,1216,0,1159,57,1216,104142,106176,861,2020-07-14
Sardegna,4,0,6,10,1230,134,1374,1,1361,13,1374,79670,94052,845,2020-07-14
Umbria,4,0,4,8,1362,80,1450,0,1434,16,1450,71359,107301,1036,2020-07-14
PA Bolzano,6,0,89,95,2287,292,2674,1,2674,0,2674,46009,92044,704,2020-07-14
Sicilia,4,0,133,137,2695,283,3115,15,2753,362,3115,192474,238702,2748,2020-07-14
Abruzzo,19,0,102,121,2740,467,3328,0,3113,215,3328,76420,115444,268,2020-07-14
Friuli Venezia Giulia,4,0,82,86,2907,345,3338,3,3331,7,3338,114618,214706,1992,2020-07-14
Molise,1,0,8,9,414,23,446,0,444,2,446,23741,24875,165,2020-07-14
Puglia,10,0,58,68,3926,547,4541,0,2052,2489,4541,138661,204917,2661,2020-07-14
PA Trento,2,0,24,26,4450,405,4881,0,3381,1500,4881,67405,134858,329,2020-07-14
Marche,4,0,156,160,5658,987,6805,1,6805,0,6805,90950,150309,794,2020-07-14
Lazio,188,10,696,894,6616,846,8356,18,6086,2270,8356,306387,373026,2564,2020-07-14
Liguria,23,0,171,194,8283,1561,10038,6,8459,1579,10038,87873,164739,1330,2020-07-14
Toscana,8,2,301,311,8894,1125,10330,4,10107,223,10330,251778,375745,2892,2020-07-14
Veneto,29,2,396,427,16952,2041,19420,19,19287,133,19420,442646,1076719,6796,2020-07-14
Emilia-Romagna,93,9,1087,1189,23511,4271,28971,13,28103,868,28971,330870,554781,4911,2020-07-14
Piemonte,175,9,730,914,26478,4115,31507,3,26106,5401,31507,280065,454092,3841,2020-07-14
Campania,16,1,235,252,4095,432,4779,0,4718,61,4779,151799,304517,1098,2020-07-14
Basilicata,3,0,2,5,374,27,406,0,401,5,406,42071,42851,288,2020-07-14
Lombardia,168,30,7813,8011,70375,16757,95143,94,89209,5934,95143,689917,1149414,6482,2020-07-13
Valle d'Aosta,2,0,1,3,1047,146,1196,0,1079,117,1196,14554,19599,102,2020-07-13
Calabria,4,0,53,57,1062,97,1216,0,1159,57,1216,103281,105315,281,2020-07-13
Sardegna,3,0,7,10,1229,134,1373,1,1360,13,1373,78923,93207,516,2020-07-13
Umbria,4,0,4,8,1362,80,1450,0,1434,16,1450,70762,106265,235,2020-07-13
PA Bolzano,6,0,89,95,2286,292,2673,7,2673,0,2673,45433,91340,174,2020-07-13
Sicilia,6,0,117,123,2694,283,3100,1,2749,351,3100,190293,235954,780,2020-07-13
Abruzzo,19,0,124,143,2719,466,3328,0,3113,215,3328,76243,115176,57,2020-07-13
Friuli Venezia Giulia,3,0,77,80,2910,345,3335,0,3328,7,3335,113993,212714,518,2020-07-13
Molise,1,0,12,13,410,23,446,0,444,2,446,23582,24710,63,2020-07-13
Puglia,10,0,58,68,3926,547,4541,0,2056,2485,4541,137079,202256,837,2020-07-13
PA Trento,2,0,24,26,4450,405,4881,0,3381,1500,4881,67232,134529,97,2020-07-13
Marche,4,0,155,159,5658,987,6804,0,6804,0,6804,90393,149515,361,2020-07-13
Lazio,191,11,690,892,6601,845,8338,24,6076,2262,8338,304024,370462,3001,2020-07-13
Liguria,24,0,194,218,8255,1559,10032,1,8466,1566,10032,87165,163409,390,2020-07-13
Toscana,7,3,325,335,8869,1122,10326,4,10105,221,10326,250093,372853,1581,2020-07-13
Veneto,22,3,387,412,16950,2039,19401,6,19282,119,19401,440190,1069923,4479,2020-07-13
Emilia-Romagna,93,9,1091,1193,23496,4269,28958,18,28096,862,28958,328603,549870,2007,2020-07-13
Piemonte,180,9,864,1053,26339,4112,31504,6,26141,5363,31504,278248,450251,1133,2020-07-13
Campania,16,0,237,253,4094,432,4779,7,4718,61,4779,151102,303419,530,2020-07-13
Basilicata,3,0,2,5,374,27,406,0,401,5,406,41783,42563,309,2020-07-13
Lombardia,160,31,7813,8004,70297,16748,95049,77,89163,5886,95049,685763,1142932,9545,2020-07-12
Valle d'Aosta,2,0,1,3,1047,146,1196,0,1079,117,1196,14500,19497,88,2020-07-12
Calabria,4,0,53,57,1062,97,1216,28,1159,57,1216,103000,105034,559,2020-07-12
Sardegna,3,0,6,9,1229,134,1372,0,1360,12,1372,78515,92691,405,2020-07-12
Umbria,4,0,5,9,1361,80,1450,2,1434,16,1450,70601,106030,647,2020-07-12
PA Bolzano,6,0,82,88,2286,292,2666,5,2666,0,2666,45318,91166,746,2020-07-12
Sicilia,5,0,118,123,2693,283,3099,0,2749,350,3099,189943,235174,1516,2020-07-12
Abruzzo,22,0,128,150,2713,465,3328,5,3116,212,3328,76203,115119,900,2020-07-12
Friuli Venezia Giulia,2,0,77,79,2911,345,3335,0,3328,7,3335,113699,212196,1194,2020-07-12
Molise,1,0,12,13,410,23,446,1,444,2,446,23519,24647,201,2020-07-12
Puglia,12,0,59,71,3924,546,4541,0,2076,2465,4541,136109,201419,1614,2020-07-12
PA Trento,2,0,24,26,4450,405,4881,0,3381,1500,4881,67162,134432,1629,2020-07-12
Marche,4,0,163,167,5650,987,6804,1,6804,0,6804,90191,149154,1051,2020-07-12
Lazio,197,12,704,913,6557,844,8314,20,6069,2245,8314,301453,367461,2585,2020-07-12
Liguria,25,0,214,239,8233,1559,10031,0,8475,1556,10031,86925,163019,1028,2020-07-12
Toscana,8,3,320,331,8869,1122,10322,1,10101,221,10322,249202,371272,2784,2020-07-12
Veneto,20,3,385,408,16948,2039,19395,16,19282,113,19395,438873,1065444,5628,2020-07-12
Emilia-Romagna,93,10,1077,1180,23491,4269,28940,71,28091,849,28940,327651,547863,2975,2020-07-12
Piemonte,190,9,859,1058,26329,4111,31498,4,26147,5351,31498,278029,449118,1952,2020-07-12
Campania,13,0,233,246,4094,432,4772,3,4711,61,4772,150757,302889,1212,2020-07-12
Basilicata,3,0,2,5,374,27,406,0,401,5,406,41474,42254,0,2020-07-12
Lombardia,173,29,8010,8212,70020,16740,94972,67,89131,5841,94972,679427,1133387,7055,2020-07-11
Calabria,4,0,25,29,1062,97,1188,2,1159,29,1188,102441,104475,893,2020-07-11
Valle d'Aosta,2,0,1,3,1047,146,1196,0,1079,117,1196,14405,19409,82,2020-07-11
Sardegna,3,0,6,9,1229,134,1372,0,1360,12,1372,78149,92286,891,2020-07-11
Umbria,4,0,4,8,1360,80,1448,0,1433,15,1448,70252,105383,955,2020-07-11
PA Bolzano,6,0,76,82,2287,292,2661,3,2661,0,2661,44844,90420,709,2020-07-11
Sicilia,6,0,117,123,2693,283,3099,1,2749,350,3099,188817,233658,1891,2020-07-11
Abruzzo,25,0,122,147,2712,464,3323,2,3113,210,3323,75741,114219,831,2020-07-11
Friuli Venezia Giulia,1,0,78,79,2911,345,3335,2,3328,7,3335,112962,211002,1841,2020-07-11
Molise,0,0,12,12,410,23,445,0,444,1,445,23324,24446,151,2020-07-11
Puglia,12,0,59,71,3924,546,4541,1,2076,2465,4541,135169,199805,1717,2020-07-11
PA Trento,2,0,26,28,4448,405,4881,2,3381,1500,4881,66741,132803,823,2020-07-11
Marche,4,0,165,169,5647,987,6803,4,6803,0,6803,89561,148103,1020,2020-07-11
Lazio,198,13,704,915,6535,844,8294,19,6065,2229,8294,299223,364876,2564,2020-07-11
Liguria,26,0,227,253,8219,1559,10031,6,8478,1553,10031,86422,161991,1527,2020-07-11
Toscana,7,3,320,330,8869,1122,10321,5,10100,221,10321,247347,368488,2470,2020-07-11
Veneto,20,3,375,398,16942,2039,19379,10,19279,100,19379,437321,1059816,11281,2020-07-11
Emilia-Romagna,93,10,1016,1119,23481,4269,28869,47,28068,801,28869,325438,544888,4274,2020-07-11
Piemonte,190,9,870,1069,26314,4111,31494,9,26178,5316,31494,276895,447166,2723,2020-07-11
Campania,47,0,195,242,4095,432,4769,7,4708,61,4769,149873,301677,1952,2020-07-11
Basilicata,3,0,2,5,374,27,406,1,401,5,406,41474,42254,281,2020-07-11
Lombardia,201,31,8125,8357,69683,16730,94770,119,89057,5713,94770,667911,1114827,11812,2020-07-09
Calabria,4,0,24,28,1060,97,1185,0,1159,26,1185,100551,102585,943,2020-07-09
Valle d'Aosta,4,0,1,5,1045,146,1196,0,1079,117,1196,14304,19246,194,2020-07-09
Sardegna,3,0,7,10,1227,134,1371,0,1360,11,1371,76752,90529,968,2020-07-09
Umbria,3,0,4,7,1360,80,1447,0,1433,14,1447,69412,103642,1031,2020-07-09
PA Bolzano,6,0,78,84,2277,292,2653,3,2653,0,2653,43847,89077,615,2020-07-09
Sicilia,6,0,122,128,2687,283,3098,1,2749,349,3098,186170,229851,2612,2020-07-09
Abruzzo,26,0,121,147,2707,464,3318,8,3112,206,3318,74697,112505,753,2020-07-09
Friuli Venezia Giulia,2,0,73,75,2912,345,3332,1,3326,6,3332,111646,206808,2228,2020-07-09
Molise,0,0,15,15,407,23,445,0,444,1,445,23033,24149,186,2020-07-09
Puglia,14,0,60,74,3916,546,4536,0,2082,2454,4536,132160,196070,2313,2020-07-09
PA Trento,1,0,32,33,4438,405,4876,0,3380,1496,4876,66161,130754,1574,2020-07-09
Marche,5,0,168,173,5638,987,6798,4,6798,0,6798,88502,146278,1179,2020-07-09
Lazio,198,13,678,889,6520,843,8252,28,6053,2199,8252,295193,359842,2535,2020-07-09
Liguria,34,1,243,278,8174,1558,10010,4,8530,1480,10010,84825,158901,1472,2020-07-09
Toscana,11,2,324,337,8857,1120,10314,1,10093,221,10314,243990,363333,3071,2020-07-09
Veneto,17,2,373,392,16929,2037,19358,10,19274,84,19358,431327,1040189,8283,2020-07-09
Emilia-Romagna,96,10,960,1066,23434,4269,28769,29,28038,731,28769,320516,536432,5343,2020-07-09
Piemonte,193,10,921,1124,26243,4108,31475,16,26391,5084,31475,273509,441677,3427,2020-07-09
Campania,45,0,187,232,4091,432,4755,5,4694,61,4755,147644,298217,1587,2020-07-09
Basilicata,2,0,3,5,373,27,405,0,401,4,405,40976,41756,426,2020-07-09
Lombardia,211,34,8215,8460,69466,16725,94651,71,89010,5641,94651,660133,1103015,10675,2020-07-08
Calabria,4,0,24,28,1060,97,1185,1,1159,26,1185,99608,101642,905,2020-07-08
Valle d'Aosta,4,0,1,5,1045,146,1196,0,1082,114,1196,14235,19052,183,2020-07-08
Sardegna,3,0,7,10,1227,134,1371,0,1360,11,1371,75894,89561,840,2020-07-08
Umbria,3,0,4,7,1360,80,1447,0,1433,14,1447,68863,102611,1054,2020-07-08
PA Bolzano,6,0,77,83,2275,292,2650,2,2650,0,2650,43534,88462,688,2020-07-08
Sicilia,7,0,120,127,2687,283,3097,1,2749,348,3097,184302,227239,2456,2020-07-08
Abruzzo,27,0,118,145,2701,464,3310,1,3104,206,3310,74235,111752,889,2020-07-08
Friuli Venezia Giulia,8,0,74,82,2904,345,3331,4,3325,6,3331,111069,204580,1827,2020-07-08
Molise,0,0,17,17,405,23,445,0,444,1,445,22851,23963,163,2020-07-08
Puglia,14,0,64,78,3912,546,4536,1,2082,2454,4536,130637,193757,2438,2020-07-08
PA Trento,3,0,34,37,4434,405,4876,0,3380,1496,4876,65705,129180,583,2020-07-08
Marche,5,0,179,184,5623,987,6794,3,6794,0,6794,87842,145099,1010,2020-07-08
Lazio,198,13,663,874,6508,842,8224,14,6043,2181,8224,293031,357307,2002,2020-07-08
Liguria,36,1,250,287,8161,1558,10006,3,8557,1449,10006,84072,157429,1328,2020-07-08
Toscana,12,2,327,341,8854,1118,10313,7,10092,221,10313,242041,360262,3715,2020-07-08
Veneto,17,3,366,386,16928,2034,19348,7,19270,78,19348,428743,1031906,9249,2020-07-08
Emilia-Romagna,99,10,962,1071,23415,4269,28755,49,28041,714,28755,317517,531089,4877,2020-07-08
Piemonte,205,8,927,1140,26212,4107,31459,25,26476,4983,31459,271685,438250,3415,2020-07-08
Campania,36,0,192,228,4090,432,4750,3,4693,57,4750,146632,296630,1918,2020-07-08
Basilicata,1,0,4,5,373,27,405,1,401,4,405,40550,41330,228,2020-07-08
Lombardia,229,36,8809,9074,68793,16713,94580,53,88988,5592,94580,653837,1092340,3380,2020-07-07
Calabria,4,0,23,27,1060,97,1184,1,1159,25,1184,98703,100737,1032,2020-07-07
Valle d'Aosta,4,0,1,5,1045,146,1196,0,1082,114,1196,14138,18869,62,2020-07-07
Sardegna,5,0,8,13,1224,134,1371,0,1360,11,1371,75144,88721,923,2020-07-07
Umbria,3,0,5,8,1359,80,1447,0,1433,14,1447,68353,101557,1162,2020-07-07
PA Bolzano,3,0,80,83,2273,292,2648,1,2648,0,2648,43059,87774,382,2020-07-07
Sicilia,12,0,128,140,2674,282,3096,1,2749,347,3096,182429,224783,2607,2020-07-07
Abruzzo,28,0,125,153,2692,464,3309,0,3106,203,3309,73722,110863,737,2020-07-07
Friuli Venezia Giulia,7,0,65,72,2910,345,3327,1,3323,4,3327,110428,202753,2102,2020-07-07
Molise,0,0,18,18,404,23,445,0,444,1,445,22691,23800,184,2020-07-07
Puglia,12,0,67,79,3910,546,4535,0,2108,2427,4535,128899,191319,2350,2020-07-07
PA Trento,3,0,37,40,4431,405,4876,3,3380,1496,4876,65442,128597,568,2020-07-07
Marche,5,0,180,185,5619,987,6791,1,6791,0,6791,87246,144089,790,2020-07-07
Lazio,202,13,658,873,6495,842,8210,5,6035,2175,8210,291236,355305,2029,2020-07-07
Liguria,38,0,247,285,8160,1558,10003,2,8628,1375,10003,83387,156101,1465,2020-07-07
Toscana,12,1,326,339,8851,1116,10306,19,10086,220,10306,239793,356547,2685,2020-07-07
Veneto,17,2,366,385,16922,2034,19341,14,19269,72,19341,425762,1022657,9422,2020-07-07
Emilia-Romagna,98,10,952,1060,23377,4269,28706,31,28028,678,28706,314717,526212,6626,2020-07-07
Piemonte,210,8,955,1173,26154,4107,31434,5,26584,4850,31434,269654,434835,3074,2020-07-07
Campania,48,0,178,226,4089,432,4747,1,4691,56,4747,145538,294712,1344,2020-07-07
Basilicata,0,0,4,4,373,27,404,0,400,4,404,40322,41102,295,2020-07-07
Lombardia,233,36,9223,9492,68335,16700,94527,111,88967,5560,94527,651688,1088960,5855,2020-07-06
Calabria,4,0,22,26,1060,97,1183,0,1159,24,1183,97671,99705,238,2020-07-06
Valle d'Aosta,4,0,1,5,1045,146,1196,0,1082,114,1196,14101,18807,100,2020-07-06
Sardegna,3,0,7,10,1227,134,1371,1,1360,11,1371,74361,87798,245,2020-07-06
Umbria,4,0,5,9,1358,80,1447,0,1433,14,1447,67791,100395,202,2020-07-06
PA Bolzano,3,0,80,83,2272,292,2647,0,2647,0,2647,42875,87392,156,2020-07-06
Sicilia,14,2,123,139,2674,282,3095,1,2749,346,3095,180811,222176,966,2020-07-06
Abruzzo,30,0,126,156,2689,464,3309,0,3106,203,3309,73199,110126,74,2020-07-06
Friuli Venezia Giulia,9,0,62,71,2910,345,3326,0,3322,4,3326,109777,200651,663,2020-07-06
Molise,0,0,21,21,401,23,445,0,444,1,445,22519,23616,87,2020-07-06
Puglia,18,0,75,93,3898,545,4536,0,2123,2413,4536,127514,188969,727,2020-07-06
PA Trento,3,0,34,37,4431,405,4873,0,3380,1493,4873,65130,128029,143,2020-07-06
Marche,5,0,184,189,5614,987,6790,0,6790,0,6790,86700,143299,270,2020-07-06
Lazio,200,12,658,870,6493,842,8205,19,6035,2170,8205,289493,353276,2298,2020-07-06
Liguria,46,0,243,289,8154,1558,10001,2,8712,1289,10001,82633,154636,575,2020-07-06
Toscana,12,2,318,332,8841,1114,10287,2,10067,220,10287,238175,353862,1313,2020-07-06
Veneto,16,2,366,384,16919,2024,19327,1,19268,59,19327,423183,1013235,3402,2020-07-06
Emilia-Romagna,90,9,965,1064,23343,4268,28675,38,28017,658,28675,311431,519586,2371,2020-07-06
Piemonte,210,9,989,1208,26117,4104,31429,6,26659,4770,31429,268189,431761,1461,2020-07-06
Campania,42,0,185,227,4087,432,4746,27,4690,56,4746,144742,293368,775,2020-07-06
Basilicata,0,0,4,4,373,27,404,0,400,4,404,40027,40807,245,2020-07-06
Lombardia,230,36,9179,9445,68274,16697,94416,98,88891,5525,94416,647739,1083105,8772,2020-07-05
Calabria,3,0,23,26,1060,97,1183,0,1159,24,1183,97433,99467,531,2020-07-05
Valle d'Aosta,4,0,1,5,1045,146,1196,0,1082,114,1196,14039,18707,57,2020-07-05
Sardegna,4,0,8,12,1225,133,1370,1,1360,10,1370,74074,87553,309,2020-07-05
Umbria,4,0,5,9,1358,80,1447,0,1433,14,1447,67644,100193,796,2020-07-05
PA Bolzano,3,0,82,85,2270,292,2647,2,2647,0,2647,42772,87236,680,2020-07-05
Sicilia,13,2,123,138,2674,282,3094,0,2749,345,3094,180132,221210,1369,2020-07-05
Abruzzo,30,0,133,163,2682,464,3309,4,3107,202,3309,73142,110052,673,2020-07-05
Friuli Venezia Giulia,7,0,66,73,2908,345,3326,0,3322,4,3326,109389,199988,781,2020-07-05
Molise,0,0,21,21,401,23,445,0,444,1,445,22432,23529,130,2020-07-05
Puglia,20,0,90,110,3881,545,4536,0,2142,2394,4536,125961,188242,1673,2020-07-05
PA Trento,2,0,40,42,4426,405,4873,0,3380,1493,4873,65033,127886,1197,2020-07-05
Marche,5,0,189,194,5609,987,6790,1,6790,0,6790,86515,143029,998,2020-07-05
Lazio,199,11,651,861,6484,841,8186,14,6025,2161,8186,287673,350978,2345,2020-07-05
Liguria,43,3,243,289,8152,1558,9999,8,8721,1278,9999,82338,154061,1173,2020-07-05
Toscana,12,2,316,330,8841,1114,10285,9,10065,220,10285,237344,352549,2804,2020-07-05
Veneto,16,2,370,388,16915,2023,19326,8,19268,58,19326,422585,1009833,5605,2020-07-05
Emilia-Romagna,88,9,932,1029,23340,4268,28637,24,28012,625,28637,309970,517215,3011,2020-07-05
Piemonte,226,9,982,1217,26104,4102,31423,18,26686,4737,31423,267961,430300,2710,2020-07-05
Campania,36,0,165,201,4086,432,4719,5,4685,34,4719,144281,292593,1848,2020-07-05
Basilicata,0,0,4,4,373,27,404,0,400,4,404,39782,40562,0,2020-07-05
Lombardia,231,36,9159,9426,68201,16691,94318,95,88857,5461,94318,642762,1074333,10160,2020-07-04
Calabria,3,0,23,26,1060,97,1183,1,1159,24,1183,96902,98936,1084,2020-07-04
Valle d'Aosta,3,0,1,4,1046,146,1196,0,1082,114,1196,14000,18650,74,2020-07-04
Sardegna,6,0,7,13,1223,133,1369,0,1360,9,1369,73703,87244,710,2020-07-04
Umbria,4,0,5,9,1358,80,1447,1,1433,14,1447,67231,99397,909,2020-07-04
PA Bolzano,3,0,82,85,2268,292,2645,3,2645,0,2645,42385,86556,618,2020-07-04
Sicilia,15,2,121,138,2674,282,3094,3,2749,345,3094,179117,219841,2694,2020-07-04
Abruzzo,28,0,131,159,2682,464,3305,7,3108,197,3305,72652,109379,1016,2020-07-04
Friuli Venezia Giulia,6,0,67,73,2908,345,3326,8,3322,4,3326,109076,199207,2232,2020-07-04
Molise,0,0,21,21,401,23,445,0,444,1,445,22303,23399,137,2020-07-04
Puglia,21,0,90,111,3880,545,4536,3,2143,2393,4536,125029,186569,1820,2020-07-04
PA Trento,2,0,46,48,4420,405,4873,2,3380,1493,4873,64691,126689,1483,2020-07-04
Marche,5,0,198,203,5599,987,6789,0,6789,0,6789,85913,142031,1066,2020-07-04
Lazio,197,11,646,854,6477,841,8172,31,6019,2153,8172,285697,348633,2394,2020-07-04
Liguria,39,2,242,283,8150,1558,9991,4,8713,1278,9991,81739,152888,1564,2020-07-04
Toscana,11,2,311,324,8838,1114,10276,9,10058,218,10276,235764,349745,2618,2020-07-04
Veneto,16,1,371,388,16907,2023,19318,4,19265,53,19318,421242,1004228,11660,2020-07-04
Emilia-Romagna,88,8,941,1037,23309,4267,28613,51,28001,612,28613,307615,514204,5513,2020-07-04
Piemonte,225,9,983,1217,26086,4102,31405,11,26713,4692,31405,266238,427590,2538,2020-07-04
Campania,37,0,161,198,4084,432,4714,2,4683,31,4714,143232,290745,1492,2020-07-04
Basilicata,0,0,4,4,373,27,404,0,401,3,404,39782,40562,229,2020-07-04
Lombardia,241,41,9395,9677,67871,16675,94223,115,88834,5389,94223,636860,1064173,9758,2020-07-03
Calabria,4,0,21,25,1060,97,1182,1,1159,23,1182,95818,97852,938,2020-07-03
Valle d'Aosta,3,0,1,4,1046,146,1196,1,1082,114,1196,13966,18576,97,2020-07-03
Sardegna,6,0,8,14,1222,133,1369,1,1360,9,1369,72993,86534,1153,2020-07-03
Umbria,4,0,6,10,1356,80,1446,2,1432,14,1446,66783,98488,790,2020-07-03
PA Bolzano,3,0,80,83,2267,292,2642,0,2642,0,2642,42017,85938,515,2020-07-03
Sicilia,16,2,117,135,2674,282,3091,1,2749,342,3091,176956,217147,2830,2020-07-03
Abruzzo,27,0,129,156,2678,464,3298,6,3104,194,3298,71976,108363,828,2020-07-03
Friuli Venezia Giulia,6,0,62,68,2905,345,3318,4,3315,3,3318,108444,196975,2580,2020-07-03
Molise,0,0,21,21,401,23,445,0,444,1,445,22167,23262,147,2020-07-03
Puglia,21,0,88,109,3879,545,4533,3,2152,2381,4533,123414,184749,2036,2020-07-03
PA Trento,2,0,44,46,4420,405,4871,6,3380,1491,4871,64218,125206,1342,2020-07-03
Marche,6,0,221,227,5575,987,6789,0,6789,0,6789,85256,140965,1072,2020-07-03
Lazio,188,11,627,826,6475,840,8141,11,6008,2133,8141,283710,346239,2357,2020-07-03
Liguria,40,3,240,283,8146,1558,9987,3,8723,1264,9987,80887,151324,1414,2020-07-03
Toscana,13,3,307,323,8832,1112,10267,9,10049,218,10267,234084,347127,2744,2020-07-03
Veneto,19,0,371,390,16901,2023,19314,5,19263,51,19314,417996,992568,9954,2020-07-03
Emilia-Romagna,87,9,915,1011,23284,4267,28562,27,27990,572,28562,304202,508691,4403,2020-07-03
Piemonte,235,10,1030,1275,26019,4100,31394,16,26872,4522,31394,264608,425052,2405,2020-07-03
Campania,35,0,162,197,4083,432,4712,10,4682,30,4712,142219,289253,2441,2020-07-03
Basilicata,0,0,4,4,373,27,404,2,401,3,404,39553,40333,292,2020-07-03
Lombardia,241,41,9545,9827,67610,16671,94108,98,88793,5315,94108,630993,1054415,9440,2020-07-02
Calabria,4,0,21,25,1059,97,1181,0,1159,22,1181,94880,96914,988,2020-07-02
Valle d'Aosta,2,0,1,3,1046,146,1195,0,1081,114,1195,13911,18479,65,2020-07-02
Sardegna,7,0,6,13,1222,133,1368,2,1360,8,1368,72197,85381,812,2020-07-02
Umbria,3,1,7,11,1353,80,1444,3,1431,13,1444,66402,97698,1096,2020-07-02
PA Bolzano,3,0,81,84,2266,292,2642,0,2642,0,2642,41686,85423,577,2020-07-02
Sicilia,17,3,114,134,2674,282,3090,9,2749,341,3090,174795,214317,2821,2020-07-02
Abruzzo,28,0,132,160,2668,464,3292,3,3102,190,3292,71520,107535,1185,2020-07-02
Friuli Venezia Giulia,6,0,56,62,2907,345,3314,2,3311,3,3314,107907,194395,2289,2020-07-02
Molise,0,0,21,21,401,23,445,0,444,1,445,22013,23115,229,2020-07-02
Puglia,24,0,85,109,3876,545,4530,0,2154,2376,4530,122302,182713,2049,2020-07-02
PA Trento,1,0,45,46,4414,405,4865,1,3379,1486,4865,63787,123864,1290,2020-07-02
Marche,8,0,230,238,5564,987,6789,3,6789,0,6789,84572,139893,1343,2020-07-02
Lazio,188,11,632,831,6460,839,8130,11,6000,2130,8130,281743,343882,2799,2020-07-02
Liguria,41,3,237,281,8145,1558,9984,2,8737,1247,9984,80201,149910,1325,2020-07-02
Toscana,11,3,310,324,8825,1109,10258,4,10040,218,10258,232951,344383,3218,2020-07-02
Veneto,20,0,377,397,16890,2022,19309,20,19262,47,19309,415828,982614,11821,2020-07-02
Emilia-Romagna,96,9,898,1003,23267,4265,28535,27,27981,554,28535,301588,504288,4862,2020-07-02
Piemonte,248,11,1040,1299,25983,4096,31378,13,26969,4409,31378,263385,422647,3356,2020-07-02
Campania,15,0,175,190,4080,432,4702,3,4680,22,4702,140525,286812,1424,2020-07-02
Basilicata,0,0,2,2,373,27,402,0,401,1,402,39261,40041,254,2020-07-02
Lombardia,277,41,9620,9938,67422,16650,94010,109,88747,5263,94010,625197,1044975,8427,2020-07-01
Calabria,4,0,22,26,1058,97,1181,0,1159,22,1181,93892,95926,832,2020-07-01
Valle d'Aosta,2,0,1,3,1046,146,1195,0,1083,112,1195,13892,18414,151,2020-07-01
Sardegna,5,0,6,11,1222,133,1366,0,1360,6,1366,71039,84569,1130,2020-07-01
Umbria,3,1,6,10,1351,80,1441,0,1428,13,1441,65770,96602,975,2020-07-01
PA Bolzano,3,1,80,84,2266,292,2642,3,2642,0,2642,41389,84846,674,2020-07-01
Sicilia,18,3,105,126,2673,282,3081,1,2749,332,3081,172947,211496,2425,2020-07-01
Abruzzo,32,0,138,170,2655,464,3289,2,3099,190,3289,70898,106350,697,2020-07-01
Friuli Venezia Giulia,6,0,50,56,2911,345,3312,4,3311,1,3312,107364,192106,2151,2020-07-01
Molise,0,0,25,25,397,23,445,0,444,1,445,21809,22886,226,2020-07-01
Puglia,24,0,88,112,3873,545,4530,0,2159,2371,4530,120651,180664,2413,2020-07-01
PA Trento,1,0,46,47,4412,405,4864,1,3378,1486,4864,63299,122574,1259,2020-07-01
Marche,8,0,240,248,5551,987,6786,5,6786,0,6786,83726,138550,1210,2020-07-01
Lazio,190,12,630,832,6448,839,8119,9,5996,2123,8119,279387,341083,3048,2020-07-01
Liguria,42,3,235,280,8144,1558,9982,5,8747,1235,9982,79497,148585,1429,2020-07-01
Toscana,13,5,305,323,8825,1106,10254,4,10036,218,10254,231407,341165,4055,2020-07-01
Veneto,17,0,401,418,16849,2022,19289,3,19259,30,19289,411837,970793,13327,2020-07-01
Emilia-Romagna,104,10,888,1002,23242,4264,28508,16,27970,538,28508,298840,499426,3882,2020-07-01
Piemonte,260,11,1082,1353,25921,4091,31365,16,27132,4233,31365,261774,419291,4034,2020-07-01
Campania,16,0,173,189,4078,432,4699,9,4678,21,4699,139678,285388,2865,2020-07-01
Basilicata,0,0,2,2,373,27,402,0,401,1,402,39007,39787,156,2020-07-01
Lombardia,297,42,9721,10060,67197,16644,93901,62,88687,5214,93901,619851,1036548,6117,2020-06-30
Calabria,4,0,23,27,1057,97,1181,1,1159,22,1181,93060,95094,924,2020-06-30
Valle d'Aosta,4,0,0,4,1045,146,1195,1,1083,112,1195,13805,18263,115,2020-06-30
Sardegna,6,0,8,14,1219,133,1366,2,1360,6,1366,70030,83439,961,2020-06-30
Umbria,3,1,6,10,1351,80,1441,1,1428,13,1441,65217,95627,1108,2020-06-30
PA Bolzano,3,1,80,84,2263,292,2639,0,2639,0,2639,40961,84172,443,2020-06-30
Sicilia,19,3,106,128,2670,282,3080,2,2749,331,3080,171130,209071,2521,2020-06-30
Abruzzo,33,0,164,197,2626,464,3287,0,3100,187,3287,70443,105653,831,2020-06-30
Friuli Venezia Giulia,9,0,36,45,2918,345,3308,0,3307,1,3308,106632,189955,2455,2020-06-30
Molise,0,0,25,25,397,23,445,0,444,1,445,21585,22660,186,2020-06-30
Puglia,25,0,104,129,3857,545,4531,0,2173,2358,4531,118741,178251,2440,2020-06-30
PA Trento,1,0,49,50,4408,405,4863,0,3378,1485,4863,62918,121315,1147,2020-06-30
Marche,8,0,258,266,5528,991,6785,0,6785,0,6785,82950,137340,955,2020-06-30
Lazio,189,13,634,836,6437,837,8110,5,5990,2120,8110,276640,338035,2284,2020-06-30
Liguria,46,3,231,280,8139,1558,9977,3,9012,965,9977,78710,147156,1254,2020-06-30
Toscana,17,6,306,329,8817,1104,10250,2,10032,218,10250,229809,337110,2912,2020-06-30
Veneto,21,0,441,462,16812,2012,19286,8,19259,27,19286,408628,957466,8595,2020-06-30
Emilia-Romagna,108,12,890,1010,23222,4260,28492,20,27965,527,28492,296112,495544,6093,2020-06-30
Piemonte,267,12,1144,1423,25836,4090,31349,11,27273,4076,31349,259420,415257,3318,2020-06-30
Campania,29,0,152,181,4077,432,4690,24,4677,13,4690,138482,282523,3277,2020-06-30
Basilicata,1,0,2,3,372,27,402,0,401,1,402,38851,39631,337,2020-06-30
Lombardia,321,43,10459,10823,66376,16640,93839,78,88821,5018,93839,615813,1030431,7991,2020-06-29
Calabria,4,0,22,26,1057,97,1180,0,1158,22,1180,92136,94170,318,2020-06-29
Valle d'Aosta,3,0,0,3,1045,146,1194,0,1083,111,1194,13734,18148,86,2020-06-29
Sardegna,6,0,8,14,1218,132,1364,0,1360,4,1364,69332,82478,296,2020-06-29
Umbria,2,1,6,9,1351,80,1440,0,1428,12,1440,64620,94519,233,2020-06-29
PA Bolzano,2,1,82,85,2262,292,2639,2,2639,0,2639,40655,83729,284,2020-06-29
Sicilia,21,3,103,127,2670,281,3078,1,2748,330,3078,169019,206550,1058,2020-06-29
Abruzzo,28,2,252,282,2543,462,3287,1,3102,185,3287,69874,104822,264,2020-06-29
Friuli Venezia Giulia,12,0,24,36,2927,345,3308,0,3307,1,3308,105815,187500,719,2020-06-29
Molise,0,0,26,26,396,23,445,0,444,1,445,21400,22474,75,2020-06-29
Puglia,28,0,117,145,3843,543,4531,0,2241,2290,4531,117104,175811,843,2020-06-29
PA Trento,1,0,52,53,4405,405,4863,0,3378,1485,4863,62092,120168,103,2020-06-29
Marche,9,0,265,274,5520,991,6785,0,6785,0,6785,82326,136385,268,2020-06-29
Lazio,190,13,637,840,6428,837,8105,9,5987,2118,8105,274704,335751,1899,2020-06-29
Liguria,47,3,227,277,8139,1558,9974,7,9019,955,9974,78097,145902,791,2020-06-29
Toscana,14,6,307,327,8817,1104,10248,5,10049,199,10248,228057,334198,1440,2020-06-29
Veneto,17,1,444,462,16808,2008,19278,3,19257,21,19278,406042,948871,4861,2020-06-29
Emilia-Romagna,111,12,909,1032,23185,4255,28472,16,27961,511,28472,292851,489451,2721,2020-06-29
Piemonte,283,11,1196,1490,25761,4087,31338,2,27422,3916,31338,257579,411939,1126,2020-06-29
Campania,20,0,142,162,4073,431,4666,1,4664,2,4666,135740,279246,1686,2020-06-29
Basilicata,1,0,2,3,372,27,402,1,401,1,402,38514,39294,156,2020-06-29
Lombardia,323,43,10581,10947,66175,16639,93761,97,88812,4949,93761,611487,1022440,8119,2020-06-28
Valle d'Aosta,3,0,1,4,1044,146,1194,0,1083,111,1194,13681,18062,74,2020-06-28
Umbria,2,1,6,9,1351,80,1440,0,1428,12,1440,64456,94286,715,2020-06-28
Sicilia,21,4,105,130,2666,281,3077,0,2748,329,3077,168323,205492,1308,2020-06-28
Puglia,27,0,119,146,3842,543,4531,0,2258,2273,4531,116126,174968,1546,2020-06-28
Campania,39,0,124,163,4071,431,4665,0,4664,1,4665,134651,277560,1535,2020-06-28
Marche,9,0,311,320,5474,991,6785,0,6785,0,6785,82147,136117,995,2020-06-28
Calabria,4,0,22,26,1057,97,1180,1,1175,5,1180,91818,93852,480,2020-06-28
Sardegna,6,0,8,14,1218,132,1364,1,1360,4,1364,69088,82182,831,2020-06-28
Molise,0,0,26,26,396,23,445,0,444,1,445,21325,22399,166,2020-06-28
PA Bolzano,3,1,81,85,2260,292,2637,1,2637,0,2637,40487,83445,405,2020-06-28
Friuli Venezia Giulia,12,0,26,38,2925,345,3308,1,3307,1,3308,105492,186781,1130,2020-06-28
PA Trento,2,0,52,54,4404,405,4863,3,3378,1485,4863,62021,120065,1026,2020-06-28
Liguria,48,3,221,272,8137,1558,9967,4,9016,951,9967,77675,145111,955,2020-06-28
Toscana,16,6,301,323,8817,1103,10243,5,10044,199,10243,227034,332758,2893,2020-06-28
Veneto,16,1,443,460,16807,2008,19275,11,19255,20,19275,405126,944010,6593,2020-06-28
Lazio,187,13,641,841,6418,837,8096,14,5983,2113,8096,272915,333852,2253,2020-06-28
Piemonte,305,12,1178,1495,25756,4085,31336,14,27436,3900,31336,257049,410813,1977,2020-06-28
Emilia-Romagna,108,12,922,1042,23161,4253,28456,21,27956,500,28456,291041,486730,3421,2020-06-28
Abruzzo,28,2,254,284,2540,462,3286,1,3102,184,3286,69720,104558,787,2020-06-28
Basilicata,1,0,1,2,372,27,401,0,401,0,401,38358,39138,137,2020-06-28
Lombardia,415,43,10534,10992,66046,16626,93664,77,88764,4900,93664,606607,1014321,9568,2020-06-27
Valle d'Aosta,2,0,2,4,1044,146,1194,0,1083,111,1194,13635,17988,47,2020-06-27
Umbria,2,1,7,10,1350,80,1440,0,1428,12,1440,64026,93571,867,2020-06-27
Abruzzo,31,2,304,337,2487,461,3285,0,3111,174,3285,69214,103771,1165,2020-06-27
Friuli Venezia Giulia,12,0,30,42,2920,345,3307,0,3306,1,3307,105108,185651,1827,2020-06-27
Puglia,27,0,120,147,3841,543,4531,0,2258,2273,4531,115265,173422,1454,2020-06-27
Campania,45,0,118,163,4071,431,4665,0,4664,1,4665,133632,276025,3151,2020-06-27
Calabria,9,0,22,31,1051,97,1179,1,1175,4,1179,91388,93372,924,2020-06-27
Sardegna,6,0,7,13,1218,132,1363,1,1360,3,1363,68359,81351,805,2020-06-27
Molise,0,0,26,26,396,23,445,0,444,1,445,21165,22233,225,2020-06-27
Sicilia,20,4,106,130,2666,281,3077,1,2748,329,3077,167299,204184,2348,2020-06-27
PA Bolzano,4,1,82,87,2257,292,2636,2,2636,0,2636,40235,83040,599,2020-06-27
Marche,9,0,348,357,5437,991,6785,2,6785,0,6785,81511,135122,1175,2020-06-27
Veneto,18,1,463,482,16775,2007,19264,2,19253,11,19264,403556,937417,20932,2020-06-27
Liguria,49,3,216,268,8138,1557,9963,5,9013,950,9963,77180,144156,1487,2020-06-27
Piemonte,303,12,1188,1503,25739,4080,31322,11,27491,3831,31322,255473,408836,2715,2020-06-27
Toscana,14,6,298,318,8817,1103,10238,12,10039,199,10238,225524,329865,3220,2020-06-27
Lazio,185,13,629,827,6418,837,8082,18,5977,2105,8082,271209,331599,2525,2020-06-27
Emilia-Romagna,106,11,924,1041,23142,4252,28435,42,27951,484,28435,288719,483309,4368,2020-06-27
PA Trento,2,0,49,51,4404,405,4860,1,3375,1485,4860,61511,119039,1638,2020-06-27
Basilicata,1,0,6,7,367,27,401,0,401,0,401,38221,39001,311,2020-06-27
Lombardia,501,47,11092,11640,65323,16624,93587,156,88720,4867,93587,600985,1004753,14101,2020-06-26
Calabria,9,0,21,30,1051,97,1178,3,1175,3,1178,90414,92448,1165,2020-06-26
Valle d'Aosta,2,0,2,4,1044,146,1194,0,1083,111,1194,13610,17941,93,2020-06-26
Sardegna,5,0,7,12,1218,132,1362,0,1360,2,1362,67848,80546,1124,2020-06-26
Umbria,2,1,7,10,1351,79,1440,1,1428,12,1440,63545,92704,872,2020-06-26
PA Bolzano,3,1,81,85,2257,292,2634,0,2634,0,2634,39893,82441,594,2020-06-26
Sicilia,18,4,107,129,2666,281,3076,0,2748,328,3076,165403,201836,2291,2020-06-26
Abruzzo,30,2,326,358,2466,461,3285,1,3112,173,3285,68584,102606,792,2020-06-26
Friuli Venezia Giulia,13,0,35,48,2914,345,3307,2,3306,1,3307,104501,183824,2846,2020-06-26
Molise,1,0,28,29,393,23,445,1,444,1,445,20958,22008,516,2020-06-26
Puglia,27,0,126,153,3835,543,4531,1,2308,2223,4531,113789,171968,1684,2020-06-26
PA Trento,1,0,51,52,4402,405,4859,4,3375,1484,4859,60783,117401,1463,2020-06-26
Marche,10,0,397,407,5385,991,6783,2,6781,2,6783,80847,133947,940,2020-06-26
Lazio,185,13,618,816,6412,836,8064,13,5971,2093,8064,269189,329074,2423,2020-06-26
Liguria,54,3,207,264,8138,1556,9958,4,9014,944,9958,76437,142669,1197,2020-06-26
Toscana,21,6,287,314,8809,1103,10226,2,10027,199,10226,223804,326645,2781,2020-06-26
Veneto,16,1,470,487,16768,2007,19262,5,19252,10,19262,398960,916485,7612,2020-06-26
Emilia-Romagna,109,12,923,1044,23097,4252,28393,46,27944,449,28393,285701,478941,4491,2020-06-26
Piemonte,307,14,1264,1585,25649,4077,31311,15,27693,3618,31311,253971,406121,3940,2020-06-26
Campania,41,1,122,164,4070,431,4665,3,4664,1,4665,131984,272874,1414,2020-06-26
Basilicata,1,0,6,7,367,27,401,0,401,0,401,37910,38690,429,2020-06-26
Lombardia,622,48,11322,11992,64831,16608,93431,170,88676,4755,93431,592797,990652,9832,2020-06-25
Calabria,10,0,18,28,1050,97,1175,0,1175,0,1175,89249,91283,1021,2020-06-25
Valle d'Aosta,2,0,3,5,1043,146,1194,0,1084,110,1194,13560,17848,148,2020-06-25
Sardegna,6,0,8,14,1216,132,1362,1,1360,2,1362,67025,79422,973,2020-06-25
Umbria,3,1,6,10,1350,79,1439,0,1428,11,1439,63068,91832,994,2020-06-25
PA Bolzano,3,1,83,87,2255,292,2634,0,2634,0,2634,39601,81847,830,2020-06-25
Sicilia,17,5,108,130,2666,280,3076,2,2748,328,3076,163991,199545,2266,2020-06-25
Abruzzo,32,2,337,371,2452,461,3284,1,3113,171,3284,68098,101814,896,2020-06-25
Friuli Venezia Giulia,12,0,41,53,2907,345,3305,0,3305,0,3305,103759,180978,2245,2020-06-25
Molise,2,0,34,36,385,23,444,0,444,0,444,20460,21492,227,2020-06-25
Puglia,27,0,146,173,3814,543,4530,1,2443,2087,4530,112532,170284,1896,2020-06-25
PA Trento,1,0,51,52,4398,405,4855,3,3374,1481,4855,60448,115938,1442,2020-06-25
Marche,10,0,450,460,5330,991,6781,2,6778,3,6781,80229,133007,1385,2020-06-25
Lazio,181,12,669,862,6354,835,8051,12,5969,2082,8051,267089,326651,2159,2020-06-25
Liguria,56,1,202,259,8139,1556,9954,14,9033,921,9954,75828,141472,1562,2020-06-25
Toscana,24,6,294,324,8799,1101,10224,2,10107,117,10224,222294,323864,3065,2020-06-25
Veneto,29,1,497,527,16724,2006,19257,4,19251,6,19257,397538,908873,11367,2020-06-25
Emilia-Romagna,114,11,943,1068,23034,4249,28351,47,27949,402,28351,282325,474450,7838,2020-06-25
Piemonte,316,15,1350,1681,25544,4071,31296,20,27972,3324,31296,252094,402181,3558,2020-06-25
Campania,47,0,117,164,4067,431,4662,17,4661,1,4662,131319,271460,1983,2020-06-25
Basilicata,1,0,6,7,367,27,401,0,401,0,401,37481,38261,374,2020-06-25
Lombardia,2715,271,51898,54884,90774,17310,162968,5035,133215,29753,162968,1729725,2766999,29960,2020-10-27
Valle d'Aosta,99,7,1261,1367,1203,156,2726,57,2428,298,2726,24643,38828,497,2020-10-27
Calabria,117,9,2199,2325,1768,111,4204,234,1174,3030,4204,260697,262979,2858,2020-10-27
PA Bolzano,169,12,3557,3738,2959,300,6997,242,6997,0,6997,115563,223079,1772,2020-10-27
Umbria,248,37,4476,4761,3001,110,7872,314,2672,5200,7872,164539,281634,3345,2020-10-27
PA Trento,84,5,1559,1648,6087,427,8162,257,4616,3546,8162,111986,277349,1345,2020-10-27
Sardegna,306,36,4719,5061,2904,199,8164,174,3161,5003,8164,215251,253445,2544,2020-10-27
Friuli Venezia Giulia,139,31,3275,3445,4913,378,8736,241,7886,850,8736,222085,515566,4422,2020-10-27
Abruzzo,284,22,4303,4609,3618,532,8759,345,6641,2118,8759,170530,272901,2844,2020-10-27
Basilicata,68,7,1001,1076,661,44,1781,77,534,1247,1781,96865,98015,1459,2020-10-27
Marche,250,28,3947,4225,6827,1006,12058,380,12058,0,12058,179841,307045,2705,2020-10-27
Sicilia,727,103,10904,11734,6142,449,18325,860,11733,6592,18325,464116,654651,7324,2020-10-27
Liguria,837,45,6075,6957,15922,1718,24597,1127,17732,6865,24597,218449,418646,6357,2020-10-27
Toscana,804,119,20117,21040,12954,1290,35284,1823,28054,7230,35284,688497,1027459,13502,2020-10-27
Lazio,1632,166,24344,26142,10648,1139,37929,1993,14055,23874,37929,1091869,1338385,25222,2020-10-27
Campania,1210,140,31491,32841,9907,607,43355,2761,40855,2500,43355,602980,886553,14781,2020-10-27
Veneto,664,83,18770,19517,25131,2344,46992,1526,24220,22772,46992,880224,2259786,13688,2020-10-27
Emilia-Romagna,934,103,16043,17080,27626,4579,49285,1413,38049,11236,49285,818615,1509935,21401,2020-10-27
Piemonte,2016,121,21103,23240,32092,4286,59618,2458,30000,29618,59618,585298,968047,12547,2020-10-27
Puglia,635,62,8011,8708,6187,686,15581,611,4463,11118,15581,377074,531155,5147,2020-10-27
Molise,17,4,671,692,664,29,1385,66,1336,49,1385,56971,60629,678,2020-10-27
Lombardia,3072,292,58042,61406,91763,17357,170526,7558,138923,31603,170526,1755084,2808259,41260,2020-10-28
Valle d'Aosta,107,7,1316,1430,1216,157,2803,77,2496,307,2803,24935,39314,486,2020-10-28
Calabria,120,11,2373,2504,1785,111,4400,196,1174,3226,4400,263352,266246,3267,2020-10-28
PA Bolzano,181,15,3725,3921,2962,304,7187,190,7187,0,7187,116456,225141,2062,2020-10-28
Umbria,255,37,4707,4999,3160,114,8273,401,2723,5550,8273,167083,286380,4746,2020-10-28
PA Trento,94,6,1667,1767,6154,432,8353,191,4744,3609,8353,112387,280137,2788,2020-10-28
Sardegna,298,37,5013,5348,2973,205,8526,362,3243,5283,8526,218343,257266,3821,2020-10-28
Friuli Venezia Giulia,146,35,3551,3732,5028,382,9142,406,8208,934,9142,223790,521139,5573,2020-10-28
Abruzzo,306,26,4697,5029,3630,534,9193,434,6889,2304,9193,172659,276681,3780,2020-10-28
Basilicata,73,7,1104,1184,670,47,1901,120,624,1277,1901,98626,99466,1451,2020-10-28
Marche,250,32,4244,4526,6875,1008,12409,351,12409,0,12409,181572,310091,3046,2020-10-28
Sicilia,787,111,11290,12188,6386,459,19033,708,12141,6892,19033,468458,662150,7499,2020-10-28
Liguria,878,46,6554,7478,16312,1733,25523,926,18076,7447,25523,221286,424986,6340,2020-10-28
Toscana,857,130,21373,22360,13335,1297,36992,1708,29543,7449,36992,696653,1041270,13811,2020-10-28
Lazio,1669,166,26111,27946,10788,1158,39892,1963,14597,25295,39892,1111817,1361332,22947,2020-10-28
Campania,1235,160,33491,34886,10272,624,45782,2427,43234,2548,45782,611945,901583,15030,2020-10-28
Veneto,708,90,20802,21600,25180,2355,49135,2143,24377,24758,49135,886165,2275869,16083,2020-10-28
Emilia-Romagna,999,119,17112,18230,27671,4593,50494,1212,38677,11817,50494,827354,1531311,21376,2020-10-28
Piemonte,2237,135,23415,25787,32353,4305,62445,2827,30854,31591,62445,599224,984720,16673,2020-10-28
Puglia,690,70,8677,9437,6217,699,16353,772,4657,11696,16353,383008,537592,6437,2020-10-28
Molise,19,4,676,699,674,31,1404,19,1354,50,1404,57441,61105,476,2020-10-28
Lombardia,692,48,11487,12227,64448,16586,93261,+88,980820,586567,,,,,2020-06-24
Calabria,9,0,19,28,1050,97,1175,0,90262,88228,,,,,2020-06-24
Valle d'Aosta,3,0,3,6,1042,146,1194,+1,17700,13497,,,,,2020-06-24
Sardegna,7,0,8,15,1214,132,1361,+1,78449,66202,,,,,2020-06-24
Umbria,3,1,7,11,1349,79,1439,+1,90838,62477,,,,,2020-06-24
Bolzano,3,1,86,90,2252,292,2634,+1,81017,39241,,,,,2020-06-24
Sicilia,17,5,110,132,2662,280,3074,+1,197279,162675,,,,,2020-06-24
Abruzzo,41,2,335,378,2444,461,3283,+1,100918,67617,,,,,2020-06-24
Friuli VG,13,0,44,57,2904,344,3305,0,178733,103086,,,,,2020-06-24
Molise,2,0,41,43,378,23,444,0,21265,20247,,,,,2020-06-24
Trento,0,0,52,52,4395,405,4852,0,114496,59700,,,,,2020-06-24
Campania,35,0,113,148,4066,431,4645,+11,269477,130025,,,,,2020-06-24
Marche,12,0,459,471,5314,994,6779,+4,131622,79407,,,,,2020-06-24
Lazio,181,13,675,869,6337,833,8039,+6,324492,265507,,,,,2020-06-24
Liguria,59,1,201,261,8124,1555,9940,+1,139910,75134,,,,,2020-06-24
Toscana,26,5,299,330,8791,1101,10222,+5,320799,221190,,,,,2020-06-24
Veneto,26,1,522,549,16700,2004,19253,+3,897506,394533,,,,,2020-06-24
Emilia Romagna,117,12,945,1074,22985,4245,28304,+44,466612,277700,,,,,2020-06-24
Piemonte,334,18,1378,1730,25480,4066,31276,+22,398623,249804,,,,,2020-06-24
Puglia,29,0,148,177,3809,543,4529,0,168388,111420,,,,,2020-06-24
Basilicata,1,0,6,7,367,27,401,0,37887,37107,,,,,2020-06-24
Lombardia,910,51,11942,12903,63691,16579,93173,+62,971721,580317,,,,,2020-06-23
Calabria,9,0,19,28,1050,97,1175,+1,89226,87180,,,,,2020-06-23
Valle d'Aosta,3,0,2,5,1042,146,1193,0,17589,13474,,,,,2020-06-23
Sardegna,7,0,8,15,1213,132,1360,0,77129,65151,,,,,2020-06-23
Umbria,4,1,7,12,1348,78,1438,0,89831,61929,,,,,2020-06-23
Bolzano,3,1,85,89,2252,292,2633,0,80538,38949,,,,,2020-06-23
Sicilia,17,5,110,132,2661,280,3073,+1,194935,161423,,,,,2020-06-23
Abruzzo,46,3,342,391,2431,460,3282,0,99976,67151,,,,,2020-06-23
Friuli VG,14,0,57,71,2890,344,3305,0,176470,102267,,,,,2020-06-23
Molise,3,0,40,43,378,23,444,0,20902,19888,,,,,2020-06-23
Trento,0,0,51,51,3948,466,4465,+1,113091,59170,,,,,2020-06-23
Campania,47,0,94,141,4062,431,4634,+10,267306,128347,,,,,2020-06-23
Marche,11,0,482,493,5288,994,6775,+1,130121,78583,,,,,2020-06-23
Lazio,184,16,686,886,6315,832,8033,+8,322341,263506,,,,,2020-06-23
Liguria,61,1,193,255,8131,1553,9939,+4,138694,74514,,,,,2020-06-23
Toscana,20,6,311,337,8780,1100,10217,+6,316933,219565,,,,,2020-06-23
RVoemnaegtona,30,1,533,564,16682,2004,19250,+3,888273,392124,,,,,2020-06-23
Emilia,121,12,956,1089,22935,4236,28260,+17,460600,273800,,,,,2020-06-23
Piemonte,330,18,1522,1870,25325,4059,31254,+6,394940,247598,,,,,2020-06-23
Puglia,32,0,158,190,3797,542,4529,+2,165598,109358,,,,,2020-06-23
Basilicata,1,0,7,8,366,27,401,0,37613,36833,,,,,2020-06-23
Lombardia,1047,51,12540,13638,62900,16573,93111,+143,964735,575981,,,,,2020-06-22
Calabria,15,0,18,33,1044,97,1174,+1,88372,86321,,,,,2020-06-22
Valle d'Aosta,4,0,1,5,1042,146,1193,0,18239,13294,,,,,2020-06-22
Sardegna,9,0,19,28,1209,132,1369,0,76379,64582,,,,,2020-06-22
Umbria,4,1,8,13,1347,78,1438,0,88714,61375,,,,,2020-06-22
Bolzano,4,1,84,89,2252,292,2633,+11,80085,38636,,,,,2020-06-22
Sicilia,20,6,115,141,2651,280,3072,0,192138,159796,,,,,2020-06-22
Abruzzo,49,3,342,394,2428,460,3282,+1,98872,66466,,,,,2020-06-22
Friuli VG,15,0,57,72,2889,344,3305,0,175706,101622,,,,,2020-06-22
Molise,3,0,40,43,378,23,444,+3,20752,19740,,,,,2020-06-22
Trento,0,0,53,53,3945,466,4464,+1,112483,58794,,,,,2020-06-22
Campania,40,0,93,133,4060,431,4624,+7,266472,127669,,,,,2020-06-22
Marche,13,0,492,505,5275,994,6774,+3,129281,78060,,,,,2020-06-22
Lazio,201,23,721,945,6250,830,8025,+8,319581,260369,,,,,2020-06-22
Liguria,58,1,191,250,8133,1552,9935,+8,137579,73979,,,,,2020-06-22
Toscana,18,9,333,360,8752,1099,10211,+1,313455,218271,,,,,2020-06-22
Veneto,29,1,555,585,16659,2003,19247,+2,882529,390386,,,,,2020-06-22
Emilia Romagna,129,12,1013,1154,22854,4235,28243,+22,455992,271706,,,,,2020-06-22
Piemonte,346,19,1605,1970,25223,4055,31248,+7,391668,246563,,,,,2020-06-22
Puglia,33,0,185,218,3769,540,4527,0,162940,107702,,,,,2020-06-22
Basilicata,1,0,7,8,366,27,401,0,37370,36590,,,,,2020-06-22
Lombardia,1260,53,12530,13843,62555,16570,92968,+128,956959,570750,,,,,2020-06-21
Calabria,17,0,19,36,1040,97,1173,+6,87935,85884,,,,,2020-06-21
Valle d'Aosta,4,0,1,5,1042,146,1193,0,17392,13294,,,,,2020-06-21
Sardegna,9,0,19,28,1209,132,1369,0,76086,64324,,,,,2020-06-21
Umbria,4,1,10,15,1345,78,1438,0,88509,61227,,,,,2020-06-21
Bolzano,4,1,70,75,2255,292,2622,+4,79863,38519,,,,,2020-06-21
Sicilia,20,6,115,141,2651,280,3072,+2,191042,158911,,,,,2020-06-21
Abruzzo,50,3,350,403,2419,459,3281,0,98708,66342,,,,,2020-06-21
Friuli VG,16,0,62,78,2883,344,3305,+1,174652,101192,,,,,2020-06-21
Molise,2,0,38,40,378,23,441,0,20656,19644,,,,,2020-06-21
Trento,0,0,53,53,3944,466,4463,+5,111714,58345,,,,,2020-06-21
Campania,41,1,84,126,4060,431,4617,+2,265122,127385,,,,,2020-06-21
Marche,14,0,513,527,5247,994,6768,0,128759,77465,,,,,2020-06-21
Lazio,247,39,705,991,6199,827,8017,+8,318264,259128,,,,,2020-06-21
Liguria,59,2,187,248,8130,1549,9927,+7,136647,73566,,,,,2020-06-21
Toscana,19,9,337,365,8750,1095,10210,+3,311877,217330,,,,,2020-06-21
Veneto,28,1,554,583,16660,2002,19245,+7,876915,388938,,,,,2020-06-21
Emilia Romagna,131,12,1029,1172,22818,4231,28221,+23,453854,270279,,,,,2020-06-21
Piemonte,356,19,1638,2013,25177,4051,31241,+26,390209,246075,,,,,2020-06-21
Puglia,32,1,189,222,3765,540,4527,+2,161902,106637,,,,,2020-06-21
Basilicata,1,0,7,8,366,27,401,0,37305,36515,,,,,2020-06-21
Lombardia,1401,54,12456,13911,62372,16557,92840,+165,949134,565933,,,,,2020-06-20
Calabria,18,0,12,30,1040,97,1167,+3,87292,85241,,,,,2020-06-20
Valle d'Aosta,4,0,2,6,1041,146,1193,+2,17297,13234,,,,,2020-06-20
Sardegna,9,0,19,28,1209,132,1369,+1,75217,63646,,,,,2020-06-20
Umbria,5,2,10,17,1343,78,1438,0,87789,60857,,,,,2020-06-20
Bolzano,3,1,72,76,2250,292,2618,0,79333,38276,,,,,2020-06-20
Abruzzo,49,3,352,404,2418,459,3281,+1,97625,65606,,,,,2020-06-20
Friuli VG,16,1,66,83,2877,344,3304,+1,171947,99462,,,,,2020-06-20
Sicilia,21,5,114,140,2650,280,3070,0,189938,157946,,,,,2020-06-20
Molise,2,0,51,53,365,23,441,0,20441,19445,,,,,2020-06-20
Trento,1,0,50,51,3941,466,4458,0,110268,57678,,,,,2020-06-20
Campania,48,1,76,125,4059,431,4615,0,263560,126398,,,,,2020-06-20
Marche,13,0,526,539,5235,994,6768,0,127450,76777,,,,,2020-06-20
Lazio,247,39,701,987,6195,827,8009,+14,316109,257265,,,,,2020-06-20
Liguria,61,3,186,250,8125,1545,9920,+10,135379,73012,,,,,2020-06-20
Toscana,19,12,383,414,8698,1095,10207,+2,309250,215914,,,,,2020-06-20
RVoemnaegtona,27,1,547,575,16661,2002,19238,+3,870830,387501,,,,,2020-06-20
Emilia,140,11,1056,1207,22761,4230,28198,+28,449616,266062,,,,,2020-06-20
Piemonte,358,17,1713,2088,25082,4045,31215,+27,387713,244951,,,,,2020-06-20
Puglia,32,1,187,220,3765,540,4525,+5,160662,105780,,,,,2020-06-20
Basilicata,0,1,7,8,366,27,401,0,36975,36185,,,,,2020-06-20
Lombardia,1537,60,12448,14045,62096,16534,92675,+157,939820,560376,,,,,2020-06-19
Calabria,18,0,16,34,1034,97,1165,0,86273,84222,,,,,2020-06-19
Valle d'Aosta,4,0,0,4,1041,146,1191,0,17183,13182,,,,,2020-06-19
Sardegna,10,0,20,30,1206,132,1368,+1,73846,62546,,,,,2020-06-19
Umbria,5,2,10,17,1344,77,1438,+1,86693,60357,,,,,2020-06-19
Bolzano,3,1,71,75,2248,292,2615,+2,78580,37858,,,,,2020-06-19
Abruzzo,53,1,353,407,2414,459,3280,+1,96581,64987,,,,,2020-06-19
Friuli VG,16,0,69,85,2875,343,3303,+2,170109,98912,,,,,2020-06-19
Sicilia,21,5,124,150,2640,280,3070,+3,187869,156719,,,,,2020-06-19
Molise,2,0,51,53,365,23,441,+1,20203,19208,,,,,2020-06-19
Trento,2,0,54,56,3936,466,4458,+1,108564,57050,,,,,2020-06-19
Campania,47,3,75,125,4059,431,4615,0,261642,125525,,,,,2020-06-19
Marche,14,0,546,560,5214,994,6768,0,126380,76228,,,,,2020-06-19
Lazio,247,38,703,988,6181,826,7995,+9,312708,254525,,,,,2020-06-19
Liguria,66,3,180,249,8121,1540,9910,+7,133898,72175,,,,,2020-06-19
Toscana,18,12,393,423,8687,1095,10205,+10,306489,214853,,,,,2020-06-19
RVoemnaegtona,30,1,551,582,16655,1998,19235,+2,858726,384389,,,,,2020-06-19
Emilia,145,11,1063,1219,22727,4224,28170,+27,443301,261017,,,,,2020-06-19
Piemonte,363,22,1793,2178,24971,4039,31188,+26,384705,243025,,,,,2020-06-19
Puglia,31,1,223,255,3727,538,4520,+1,158828,104225,,,,,2020-06-19
Basilicata,0,1,7,8,366,27,401,0,36705,35915,,,,,2020-06-19
Lombardia,1673,60,12914,14647,61355,16516,92518,+216,929356,554148,,,,,2020-06-18
Calabria,18,0,17,35,1033,97,1165,+3,85222,83171,,,,,2020-06-18
Valle d'Aosta,5,0,1,6,1040,145,1191,0,17057,13097,,,,,2020-06-18
Sardegna,10,0,21,31,1204,132,1367,+1,72722,61674,,,,,2020-06-18
Umbria,5,2,9,16,1344,77,1437,0,85586,59912,,,,,2020-06-18
Bolzano,8,2,75,85,2236,292,2613,+2,77954,37563,,,,,2020-06-18
Abruzzo,58,2,374,434,2389,458,3281,+2,95546,64327,,,,,2020-06-18
Friuli VG,15,1,81,97,2861,343,3301,+2,167485,97662,,,,,2020-06-18
Sicilia,24,3,610,637,2547,280,3464,+2,186253,155903,,,,,2020-06-18
Molise,1,0,59,60,357,23,440,0,19984,19006,,,,,2020-06-18
Trento,2,0,57,59,3933,465,4457,+8,107366,56609,,,,,2020-06-18
Campania,52,6,184,242,3942,431,4615,+1,259655,124683,,,,,2020-06-18
Marche,19,0,558,577,5197,994,6768,+4,125339,75604,,,,,2020-06-18
Lazio,261,38,698,997,6167,822,7986,+9,309169,251673,,,,,2020-06-18
Liguria,70,2,174,246,8121,1536,9903,+7,132375,71497,,,,,2020-06-18
Toscana,23,13,402,438,8664,1093,10195,+2,303786,213644,,,,,2020-06-18
Veneto,33,1,573,607,16632,1994,19233,+8,847997,382042,,,,,2020-06-18
Emilia Romagna,159,11,1111,1281,22643,4219,28143,+32,435351,256490,,,,,2020-06-18
Piemonte,397,25,1868,2290,24840,4032,31162,+31,380395,241279,,,,,2020-06-18
Puglia,34,1,271,306,3675,538,4519,+3,156582,103148,,,,,2020-06-18
Basilicata,0,1,9,10,364,27,401,0,36382,35592,,,,,2020-06-18
Lombardia,1796,59,13117,14972,60850,16480,92302,+242,917881,547133,,,,,2020-06-17
Calabria,18,0,15,33,1032,97,1162,0,84265,82203,,,,,2020-06-17
Valle d'Aosta,5,0,3,8,1039,144,1191,0,16918,12996,,,,,2020-06-17
Sardegna,11,0,20,31,1203,132,1366,+1,71452,60606,,,,,2020-06-17
Umbria,7,2,9,18,1342,77,1437,0,84511,59407,,,,,2020-06-17
Bolzano,8,1,78,87,2232,292,2611,0,77230,37210,,,,,2020-06-17
Abruzzo,61,2,375,438,2386,457,3281,+2,94391,63630,,,,,2020-06-17
Friuli VG,16,0,83,99,2857,343,3299,+2,166064,96534,,,,,2020-06-17
Sicilia,25,3,777,805,2377,280,3462,+2,184412,154287,,,,,2020-06-17
Molise,1,0,61,62,355,23,440,+1,19635,18684,,,,,2020-06-17
Trento,2,0,56,58,3926,465,4449,+1,105841,56032,,,,,2020-06-17
Campania,48,2,208,258,3925,431,4614,+1,258207,124041,,,,,2020-06-17
Marche,21,0,564,585,5185,994,6764,+1,123770,74827,,,,,2020-06-17
Lazio,284,38,717,1039,6120,818,7977,+10,305906,248746,,,,,2020-06-17
Liguria,73,2,169,244,8120,1532,9896,+5,130870,70737,,,,,2020-06-17
Toscana,33,14,397,444,8657,1092,10193,+2,300612,212090,,,,,2020-06-17
Veneto,37,1,642,680,16558,1987,19225,+4,837394,379280,,,,,2020-06-17
Emilia Romagna,173,11,1161,1345,22551,4215,28111,+14,426730,252139,,,,,2020-06-17
Piemonte,448,25,1912,2385,24720,4026,31131,+41,377165,238650,,,,,2020-06-17
Puglia,46,2,276,324,3656,536,4516,0,154143,101350,,,,,2020-06-17
Basilicata,0,1,9,10,364,27,401,0,36011,35221,,,,,2020-06-17
Lombardia,1902,69,13262,15233,60361,16466,92060,+143,906322,539604,,,,,2020-06-16
Calabria,18,0,18,36,1029,97,1162,0,83281,81219,,,,,2020-06-16
Valle d'Aosta,6,0,4,10,1037,144,1191,0,16764,12907,,,,,2020-06-16
Sardegna,13,0,20,33,1200,132,1365,+2,70202,59536,,,,,2020-06-16
Umbria,8,1,9,18,1342,77,1437,+1,83435,58815,,,,,2020-06-16
Bolzano,8,1,84,93,2226,292,2611,0,76661,36931,,,,,2020-06-16
Abruzzo,67,3,398,468,2355,457,3280,+1,92874,62709,,,,,2020-06-16
Friuli VG,14,0,85,99,2855,343,3297,+1,162440,95057,,,,,2020-06-16
Sicilia,32,4,770,806,2374,280,3460,+2,182514,152670,,,,,2020-06-16
Molise,1,0,64,65,351,23,439,0,19368,18444,,,,,2020-06-16
Trento,2,0,62,64,3919,465,4448,0,104696,55530,,,,,2020-06-16
Campania,57,2,214,273,3910,430,4613,0,242662,123167,,,,,2020-06-16
Marche,19,0,582,601,5168,994,6763,+1,122650,74194,,,,,2020-06-16
Lazio,308,38,783,1129,6024,814,7967,+9,302305,245960,,,,,2020-06-16
Liguria,76,2,164,242,8120,1529,9891,+4,129249,69980,,,,,2020-06-16
Toscana,34,14,415,463,8637,1091,10191,+3,296812,209629,,,,,2020-06-16
Veneto,36,1,681,718,16521,1982,19221,+1,826192,376001,,,,,2020-06-16
Emilia Romagna,180,11,1214,1405,22483,4209,28097,+13,417184,247911,,,,,2020-06-16
Piemonte,472,28,1950,2450,24622,4018,31090,+29,372948,236721,,,,,2020-06-16
Puglia,48,2,303,353,3628,535,4516,0,151482,99985,,,,,2020-06-16
Basilicata,0,1,9,10,364,27,401,0,35666,34876,,,,,2020-06-16
Lombardia,2018,94,13864,15976,59484,16457,91917,+259,899278,534981,,,,,2020-06-15
Calabria,17,1,19,37,1028,97,1162,0,82392,80330,,,,,2020-06-15
Valle d'Aosta,7,0,5,12,1035,144,1191,0,16650,12829,,,,,2020-06-15
Sardegna,12,0,21,33,1198,132,1363,0,69134,58586,,,,,2020-06-15
Umbria,9,1,8,18,1341,77,1436,0,82235,58164,,,,,2020-06-15
Bolzano,8,1,85,94,2225,292,2611,0,76345,36698,,,,,2020-06-15
Abruzzo,71,3,412,486,2337,456,3279,0,91700,62048,,,,,2020-06-15
Friuli VG,15,1,83,99,2854,343,3296,0,161945,94567,,,,,2020-06-15
Sicilia,30,4,771,805,2373,280,3458,+1,180327,150982,,,,,2020-06-15
Molise,0,0,70,70,346,23,439,0,19125,18214,,,,,2020-06-15
Trento,5,0,61,66,3917,465,4448,+1,104306,55322,,,,,2020-06-15
Campania,58,2,229,289,3894,430,4613,+4,241380,122291,,,,,2020-06-15
Marche,18,0,599,617,5152,993,6762,+4,121620,73564,,,,,2020-06-15
Lazio,304,37,951,1292,5855,811,7958,+3,299590,243805,,,,,2020-06-15
Liguria,87,2,157,246,8116,1525,9887,+8,127913,69345,,,,,2020-06-15
Toscana,31,16,442,489,8611,1088,10188,+8,293683,207371,,,,,2020-06-15
Veneto,38,1,716,755,16487,1978,19220,+1,817064,373057,,,,,2020-06-15
Emilia Romagna,188,13,1299,1500,22377,4207,28084,+11,410984,244630,,,,,2020-06-15
Piemonte,517,28,2059,2604,24445,4012,31061,+2,369294,234980,,,,,2020-06-15
Puglia,56,2,352,410,3572,534,4516,+1,148627,97877,,,,,2020-06-15
Basilicata,0,1,10,11,363,27,401,0,35233,34443,,,,,2020-06-15
Lombardia,2116,94,13779,15989,59220,16449,91658,+244,892641,530683,,,,,2020-06-14
Calabria,15,1,28,44,1021,97,1162,0,81981,79919,,,,,2020-06-14
Valle d'Aosta,7,0,0,7,1040,144,1191,0,16597,12806,,,,,2020-06-14
Sardegna,12,0,21,33,1198,132,1363,0,68769,58281,,,,,2020-06-14
Umbria,9,1,10,20,1339,77,1436,0,81976,58013,,,,,2020-06-14
Bolzano,8,2,85,95,2227,291,2613,+3,76195,36607,,,,,2020-06-14
Abruzzo,71,4,436,511,2312,456,3279,+4,91445,61873,,,,,2020-06-14
Friuli VG,15,1,87,103,2850,343,3296,0,160824,93641,,,,,2020-06-14
Sicilia,32,3,802,837,2341,279,3457,+1,179438,150233,,,,,2020-06-14
Molise,0,0,74,74,342,23,439,0,18845,17947,,,,,2020-06-14
Trento,5,1,60,66,3917,464,4447,+1,103910,55054,,,,,2020-06-14
Campania,53,2,264,319,3860,430,4609,+1,240290,121618,,,,,2020-06-14
Marche,21,0,605,626,5139,993,6758,+4,121354,73298,,,,,2020-06-14
Lazio,305,37,980,1322,5825,808,7955,+14,297615,242245,,,,,2020-06-14
Liguria,85,3,155,243,8115,1521,9879,+4,126705,68766,,,,,2020-06-14
Toscana,34,16,449,499,8596,1085,10180,+8,292101,206348,,,,,2020-06-14
Veneto,40,1,731,772,16469,1978,19219,+7,812540,371726,,,,,2020-06-14
Emilia Romagna,192,14,1431,1637,22232,4204,28073,+17,407039,241833,,,,,2020-06-14
Piemonte,517,26,2105,2648,24399,4012,31059,+30,368065,234561,,,,,2020-06-14
Puglia,57,2,359,418,3565,532,4515,0,147249,96820,,,,,2020-06-14
Basilicata,0,1,10,11,363,27,401,0,35139,34349,,,,,2020-06-14
Lombardia,2252,96,14437,16785,58201,16428,91414,+210,883305,524774,,,,,2020-06-13
Calabria,15,1,29,45,1020,97,1162,+1,81255,79193,,,,,2020-06-13
Valle d'Aosta,7,0,0,7,1040,144,1191,0,16476,12736,,,,,2020-06-13
Sardegna,12,0,22,34,1197,132,1363,0,68079,57763,,,,,2020-06-13
Umbria,10,1,10,21,1339,76,1436,0,81155,57511,,,,,2020-06-13
Bolzano,7,2,86,95,2224,291,2610,+2,75735,36393,,,,,2020-06-13
Abruzzo,72,4,433,509,2312,454,3275,+4,90340,61177,,,,,2020-06-13
Friuli VG,15,0,90,105,2848,343,3296,+6,158870,93222,,,,,2020-06-13
Sicilia,33,3,806,842,2335,279,3456,+1,178319,149516,,,,,2020-06-13
Molise,0,0,97,97,319,23,439,0,18495,17630,,,,,2020-06-13
Trento,5,1,64,70,3912,464,4446,+3,102138,54175,,,,,2020-06-13
Campania,67,2,268,337,3841,430,4608,0,234666,118820,,,,,2020-06-13
Marche,22,0,655,677,5084,993,6754,+2,120308,72713,,,,,2020-06-13
Lazio,303,45,1009,1357,5778,806,7941,+25,294654,239788,,,,,2020-06-13
Liguria,91,3,150,244,8113,1518,9875,+4,125871,68333,,,,,2020-06-13
Toscana,33,16,453,502,8588,1082,10172,+7,289524,204513,,,,,2020-06-13
Veneto,41,1,736,778,16457,1977,19212,+13,798290,368659,,,,,2020-06-13
Emilia Romagna,192,15,1520,1727,22130,4199,28056,+28,400902,237236,,,,,2020-06-13
Piemonte,510,27,2283,2820,24203,4006,31029,+40,365223,232980,,,,,2020-06-13
Puglia,60,2,360,422,3561,532,4515,0,145905,96053,,,,,2020-06-13
Basilicata,0,1,10,11,363,27,401,0,34681,33891,,,,,2020-06-13
Lombardia,2357,97,14570,17024,57775,16405,91204,+272,873831,519095,,,,,2020-06-12
Calabria,16,1,30,47,1017,97,1161,0,80063,78001,,,,,2020-06-12
Valle d'Aosta,6,0,3,9,1038,144,1191,0,16374,12671,,,,,2020-06-12
Sardegna,10,1,31,42,1190,131,1363,+1,67069,56937,,,,,2020-06-12
Umbria,10,1,13,24,1336,76,1436,0,80190,56914,,,,,2020-06-12
Bolzano,8,2,91,101,2216,291,2608,+2,74859,35974,,,,,2020-06-12
Abruzzo,76,4,448,528,2290,453,3271,+4,88739,60229,,,,,2020-06-12
Friuli VG,18,0,90,108,2840,342,3290,+3,157909,92278,,,,,2020-06-12
Sicilia,34,3,804,841,2335,279,3455,0,176233,147871,,,,,2020-06-12
Molise,1,1,112,114,302,23,439,0,18112,17279,,,,,2020-06-12
Trento,5,1,62,68,3911,464,4443,+2,100400,53453,,,,,2020-06-12
Campania,61,2,283,346,3832,430,4608,-229,230551,115842,,,,,2020-06-12
Marche,22,0,728,750,5009,993,6752,+1,119045,72169,,,,,2020-06-12
Lazio,293,47,1882,2222,4913,781,7916,+27,291869,237100,,,,,2020-06-12
Liguria,103,3,143,249,8106,1516,9871,+7,124320,67544,,,,,2020-06-12
Toscana,36,14,460,510,8575,1080,10165,+7,286693,202577,,,,,2020-06-12
Veneto,49,0,800,849,16383,1967,19199,0,795260,367579,,,,,2020-06-12
Emilia Romagna,200,17,1600,1817,22015,4196,28028,+33,393539,231752,,,,,2020-06-12
Piemonte,527,30,2340,2897,24096,3996,30989,+31,361164,230888,,,,,2020-06-12
Puglia,61,2,376,439,3544,532,4515,+2,143844,94456,,,,,2020-06-12
Basilicata,0,1,11,12,362,27,401,0,34377,33587,,,,,2020-06-12
Lombardia,2488,97,14755,17340,57218,16374,90932,+252,858994,509853,,,,,2020-06-11
Calabria,16,1,35,52,1012,97,1161,+2,79025,76963,,,,,2020-06-11
Valle d'Aosta,6,0,0,6,1041,144,1191,0,16268,12606,,,,,2020-06-11
Sardegna,10,1,32,43,1188,131,1362,+1,66133,56226,,,,,2020-06-11
Umbria,11,2,13,26,1334,76,1436,0,79234,56310,,,,,2020-06-11
Bolzano,8,2,89,99,2215,292,2606,+2,74106,35553,,,,,2020-06-11
Abruzzo,81,5,453,539,2275,453,3267,+1,87566,59505,,,,,2020-06-11
Friuli VG,22,0,90,112,2833,342,3287,+1,153763,90508,,,,,2020-06-11
Sicilia,37,5,807,849,2327,279,3455,0,174429,146290,,,,,2020-06-11
Molise,1,1,114,116,300,23,439,0,17710,16916,,,,,2020-06-11
Trento,5,1,65,71,3906,464,4441,+2,98969,52795,,,,,2020-06-11
Campania,74,2,534,610,3797,430,4837,+3,226823,114073,,,,,2020-06-11
Marche,26,0,876,902,4857,992,6751,+1,117720,71531,,,,,2020-06-11
Lazio,320,46,2151,2517,4596,776,7889,+20,287888,233158,,,,,2020-06-11
Liguria,107,3,140,250,8100,1514,9864,+10,122654,66755,,,,,2020-06-11
Toscana,42,15,464,521,8558,1079,10158,+10,283638,200500,,,,,2020-06-11
Veneto,52,0,870,922,16313,1964,19199,+5,780445,364110,,,,,2020-06-11
Emilia Romagna,216,18,1766,2000,21803,4192,27995,+25,385220,227500,,,,,2020-06-11
Piemonte,544,33,2606,3183,23787,3988,30958,+42,357957,229096,,,,,2020-06-11
Puglia,65,3,399,467,3516,530,4513,+1,141322,93130,,,,,2020-06-11
Basilicata,0,1,11,12,362,27,401,+1,33957,33167,,,,,2020-06-11
Lombardia,2565,98,15194,17857,56474,16349,90680,+99,845618,502047,,,,,2020-06-10
Calabria,18,0,36,54,1008,97,1159,0,78174,76112,,,,,2020-06-10
Valle d'Aosta,3,0,3,6,1041,144,1191,0,16141,12502,,,,,2020-06-10
Sardegna,9,1,40,50,1180,131,1361,0,65175,55439,,,,,2020-06-10
Umbria,13,2,13,28,1332,76,1436,+1,78366,55763,,,,,2020-06-10
Bolzano,7,2,85,94,2218,292,2604,0,73404,35148,,,,,2020-06-10
Abruzzo,83,5,462,550,2263,453,3266,0,86082,58766,,,,,2020-06-10
Friuli VG,25,1,87,113,2832,341,3286,+2,152866,90061,,,,,2020-06-10
Sicilia,40,6,807,853,2324,278,3455,+1,171384,144193,,,,,2020-06-10
Molise,0,2,118,120,296,23,439,+1,17375,16611,,,,,2020-06-10
Trento,6,1,73,80,3895,464,4439,0,97739,52412,,,,,2020-06-10
Campania,74,2,566,642,3764,428,4834,+1,223302,112309,,,,,2020-06-10
Marche,29,0,918,947,4811,992,6750,+3,116320,70837,,,,,2020-06-10
Lazio,368,47,2151,2566,4533,770,7869,+18,283630,229513,,,,,2020-06-10
Liguria,110,3,132,245,8096,1513,9854,+20,121023,66009,,,,,2020-06-10
Toscana,40,15,484,539,8531,1078,10148,+3,280491,198466,,,,,2020-06-10
Veneto,66,0,899,965,16268,1961,19194,+3,773316,362400,,,,,2020-06-10
Emilia Romagna,228,25,1808,2061,21717,4192,27970,+24,375278,223413,,,,,2020-06-10
Piemonte,564,35,2773,3372,23568,3976,30916,+26,353737,226874,,,,,2020-06-10
Puglia,71,4,482,557,3426,529,4512,0,138377,91918,,,,,2020-06-10
Basilicata,1,0,10,11,362,27,400,0,33551,32761,,,,,2020-06-10
Lombardia,2660,96,15541,18297,55967,16317,90581,+192,836313,496273,,,,,2020-06-09
Calabria,18,0,50,68,994,97,1159,0,77216,75154,,,,,2020-06-09
Valle d'Aosta,7,0,1,8,1039,144,1191,0,16040,12436,,,,,2020-06-09
Sardegna,9,1,44,54,1176,131,1361,-1,64272,54707,,,,,2020-06-09
Umbria,12,2,15,29,1330,76,1435,+3,77427,55145,,,,,2020-06-09
Bolzano,7,2,86,95,2217,292,2604,0,72652,34607,,,,,2020-06-09
Abruzzo,91,4,472,567,2248,451,3266,+1,84700,57880,,,,,2020-06-09
Friuli VG,21,2,105,128,2816,340,3284,0,148889,86257,,,,,2020-06-09
Sicilia,39,6,808,853,2323,278,3454,+2,168562,142495,,,,,2020-06-09
Molise,0,2,118,120,295,23,438,+2,17162,16411,,,,,2020-06-09
Trento,6,1,74,81,3894,464,4439,+3,96527,51934,,,,,2020-06-09
Campania,73,3,599,675,3732,426,4833,+5,220662,110583,,,,,2020-06-09
Marche,32,0,960,992,4763,992,6747,0,115510,70335,,,,,2020-06-09
Lazio,462,47,2061,2570,4515,766,7851,+23,279572,225930,,,,,2020-06-09
Liguria,119,5,125,249,8076,1509,9834,+8,118891,65073,,,,,2020-06-09
Toscana,46,17,565,628,8440,1077,10145,+1,277092,195695,,,,,2020-06-09
Veneto,77,0,927,1004,16226,1961,19191,+4,762098,358948,,,,,2020-06-09
Emilia Romagna,226,31,1899,2156,21605,4185,27946,+18,367485,218890,,,,,2020-06-09
Piemonte,599,39,3033,3671,23258,3961,30890,+21,348770,224293,,,,,2020-06-09
Puglia,76,5,532,613,3373,526,4512,0,135625,90248,,,,,2020-06-09
Basilicata,1,0,13,14,359,27,400,+1,33185,32395,,,,,2020-06-09
Lombardia,2708,107,16504,19319,54768,16302,90389,+194,826465,489775,,,,,2020-06-08
Calabria,18,0,59,77,985,97,1159,0,76501,74439,,,,,2020-06-08
Valle d'Aosta,7,0,1,8,1039,144,1191,0,15910,12385,,,,,2020-06-08
Sardegna,9,1,46,56,1175,131,1362,0,63510,54051,,,,,2020-06-08
Umbria,10,2,17,29,1327,76,1432,0,76413,54486,,,,,2020-06-08
Bolzano,7,2,88,97,2215,292,2604,+1,72257,34307,,,,,2020-06-08
Abruzzo,89,4,539,632,2215,418,3265,0,83715,57165,,,,,2020-06-08
Friuli VG,22,3,119,144,2800,340,3284,+1,148030,85834,,,,,2020-06-08
Sicilia,40,7,806,853,2321,278,3452,+1,165693,140109,,,,,2020-06-08
Molise,0,2,117,119,294,23,436,0,16966,16224,,,,,2020-06-08
Trento,7,1,73,81,3891,464,4436,+1,95825,51453,,,,,2020-06-08
Campania,82,6,629,717,3685,426,4828,+2,219033,109534,,,,,2020-06-08
Marche,41,2,1032,1075,4681,991,6747,+2,114310,69736,,,,,2020-06-08
Lazio,466,49,2100,2615,4450,763,7828,+16,275885,222963,,,,,2020-06-08
Liguria,125,5,118,248,8073,1505,9826,+14,117410,64349,,,,,2020-06-08
Toscana,50,20,651,721,8349,1074,10144,+9,273706,193737,,,,,2020-06-08
Veneto,82,1,997,1080,16152,1955,19187,+4,750248,355368,,,,,2020-06-08
Emilia Romagna,239,31,2012,2282,21467,4179,27928,+20,360962,215416,,,,,2020-06-08
Piemonte,633,36,3197,3866,23049,3954,30869,+14,344924,222000,,,,,2020-06-08
Puglia,94,4,600,698,3289,525,4512,+1,133164,88228,,,,,2020-06-08
Basilicata,0,0,13,13,359,27,399,0,32720,31930,,,,,2020-06-08
Lombardia,2801,107,16512,19420,54505,16270,90195,+125,821977,485842,,,,,2020-06-07
Calabria,18,0,73,91,971,97,1159,0,76142,74080,,,,,2020-06-07
Valle d'Aosta,6,0,3,9,1038,144,1191,+2,15905,12335,,,,,2020-06-07
Sardegna,10,1,48,59,1172,131,1362,0,63172,53735,,,,,2020-06-07
Umbria,10,2,17,29,1327,76,1432,+1,76179,54314,,,,,2020-06-07
Bolzano,7,2,88,97,2214,292,2603,+3,71755,33944,,,,,2020-06-07
Abruzzo,88,4,561,653,2194,418,3265,+7,83020,56702,,,,,2020-06-07
Friuli VG,22,4,125,151,2793,339,3283,0,147673,85671,,,,,2020-06-07
Sicilia,42,7,813,862,2312,277,3451,+1,164985,139481,,,,,2020-06-07
Molise,0,2,118,120,293,23,436,0,16791,16056,,,,,2020-06-07
Trento,6,1,75,82,3889,464,4435,+1,95638,51385,,,,,2020-06-07
Campania,86,6,633,725,3675,426,4826,+4,217898,108785,,,,,2020-06-07
Marche,41,2,1116,1159,4595,991,6745,+3,113729,69376,,,,,2020-06-07
Lazio,467,49,2174,2690,4362,760,7812,+11,274129,221612,,,,,2020-06-07
Liguria,127,5,111,243,8070,1499,9812,+13,116247,63749,,,,,2020-06-07
Toscana,52,20,678,750,8315,1070,10135,+1,272106,192675,,,,,2020-06-07
Veneto,81,1,1003,1085,16144,1954,19183,+1,745805,354338,,,,,2020-06-07
Emilia Romagna,245,32,2051,2328,21405,4175,27908,+14,355952,213979,,,,,2020-06-07
Piemonte,659,38,3265,3962,22952,3941,30855,+10,343354,221367,,,,,2020-06-07
Puglia,96,4,633,733,3253,525,4511,0,131931,86405,,,,,2020-06-07
Basilicata,0,0,14,14,358,27,399,0,32147,31357,,,,,2020-06-07
Lombardia,2840,110,16549,19499,54322,16249,90070,142,813972,480566,,,,,2020-06-06
Calabria,18,0,73,91,971,97,1159,0,75290,73228,,,,,2020-06-06
Valle d'Aosta,7,0,5,12,1033,144,1189,2,15730,12289,,,,,2020-06-06
Sardegna,10,1,49,60,1171,131,1362,3,62145,52956,,,,,2020-06-06
Umbria,11,2,15,28,1327,76,1431,0,75336,53733,,,,,2020-06-06
Bolzano,7,2,91,100,2208,292,2600,1,70578,33291,,,,,2020-06-06
Abruzzo,96,3,554,653,2187,418,3258,1,82332,56223,,,,,2020-06-06
Friuli VG,24,2,135,161,2784,338,3283,3,146338,84978,,,,,2020-06-06
Sicilia,47,7,812,866,2308,276,3450,2,163432,138343,,,,,2020-06-06
Molise,0,2,119,121,292,23,436,0,16522,15809,,,,,2020-06-06
Trento,6,1,97,104,3866,464,4434,1,94159,50758,,,,,2020-06-06
Campania,97,7,634,738,3658,426,4822,0,215404,105814,,,,,2020-06-06
Marche,46,3,1146,1195,4556,991,6742,2,112740,68775,,,,,2020-06-06
Lazio,477,49,2171,2697,4346,758,7801,28,271662,219363,,,,,2020-06-06
Liguria,136,4,105,245,8062,1492,9799,13,114887,63119,,,,,2020-06-06
Toscana,49,22,714,785,8281,1068,10134,5,269298,190860,,,,,2020-06-06
Veneto,82,2,1080,1164,16069,1949,19182,8,734130,351519,,,,,2020-06-06
Emilia Romagna,256,35,2125,2416,21307,4171,27894,17,351146,210719,,,,,2020-06-06
Piemonte,684,37,3446,4167,22744,3934,30845,38,340176,219444,,,,,2020-06-06
Puglia,109,4,645,758,3231,522,4511,4,129898,86405,,,,,2020-06-06
Basilicata,0,0,17,17,355,27,399,0,31882,31102,,,,,2020-06-06
Lombardia,2960,120,16773,19853,53853,16222,89928,402,800276,475041,,,,,2020-06-05
Calabria,18,0,79,97,965,97,1159,1,74186,72124,,,,,2020-06-05
Valle d'Aosta,9,0,1,10,1034,143,1187,0,15587,12200,,,,,2020-06-05
Sardegna,11,0,56,67,1161,131,1359,2,60794,51853,,,,,2020-06-05
Umbria,12,2,15,29,1326,76,1431,0,74142,52888,,,,,2020-06-05
Bolzano,10,2,89,101,2206,292,2599,1,69466,32665,,,,,2020-06-05
Abruzzo,103,4,563,670,2172,415,3257,2,80972,55295,,,,,2020-06-05
Friuli VG,25,2,153,180,2762,338,3280,1,142246,83600,,,,,2020-06-05
Sicilia,54,6,812,872,2300,276,3448,1,160639,136155,,,,,2020-06-05
Molise,0,2,120,122,291,23,436,0,15568,15568,,,,,2020-06-05
Trento,8,1,114,123,3846,464,4433,0,92916,50312,,,,,2020-06-05
Campania,133,7,634,774,3623,425,4822,0,212486,104169,,,,,2020-06-05
Marche,50,5,1238,1293,4458,989,6740,2,111431,68197,,,,,2020-06-05
Lazio,480,51,2179,2710,4309,754,7773,9,268561,216743,,,,,2020-06-05
Liguria,142,6,96,244,8056,1486,9786,14,113329,62417,,,,,2020-06-05
Toscana,55,23,779,857,8209,1063,10129,7,266508,188882,,,,,2020-06-05
Veneto,96,2,1131,1229,16007,1938,19174,6,713500,346872,,,,,2020-06-05
Emilia Romagna,281,38,2193,2512,21198,4167,27877,17,347146,207533,,,,,2020-06-05
Piemonte,743,40,3586,4369,22511,3927,30807,49,335814,217032,,,,,2020-06-05
Puglia,111,5,730,846,3140,521,4507,4,127520,85007,,,,,2020-06-05
Basilicata,0,0,18,18,354,27,399,0,31485,30705,,,,,2020-06-05
Lombardia,2954,125,17145,20224,53101,16201,89526,84,780887,460658,,,,,2020-06-04
Calabria,19,0,83,102,959,97,1158,0,73072,70813,,,,,2020-06-04
Valle d'Aosta,9,0,1,10,1034,143,1187,0,15512,12156,,,,,2020-06-04
Sardegna,12,1,95,108,1118,131,1357,0,59556,50865,,,,,2020-06-04
Umbria,15,2,14,31,1324,76,1431,0,73204,52223,,,,,2020-06-04
Bolzano,7,2,103,112,2194,292,2598,0,68513,32135,,,,,2020-06-04
Abruzzo,109,3,592,704,2136,415,3255,3,79720,54527,,,,,2020-06-04
Friuli VG,34,2,177,213,2730,336,3279,3,138942,81854,,,,,2020-06-04
Sicilia,57,6,816,879,2292,276,3447,0,157868,134035,,,,,2020-06-04
Molise,0,2,123,125,288,23,436,0,15261,15261,,,,,2020-06-04
Trento,14,1,192,207,3762,464,4433,0,91631,49920,,,,,2020-06-04
Campania,160,5,665,830,3572,420,4822,1,210001,102305,,,,,2020-06-04
Marche,52,5,1246,1303,4447,988,6738,3,110077,67429,,,,,2020-06-04
Lazio,488,51,2215,2754,4260,750,7764,11,265380,214051,,,,,2020-06-04
Liguria,149,6,239,394,7899,1479,9772,21,111587,61688,,,,,2020-06-04
Toscana,65,24,794,883,8180,1059,10122,1,262762,186632,,,,,2020-06-04
Veneto,97,2,1220,1319,15915,1934,19168,4,706475,344495,,,,,2020-06-04
Emilia Romagna,320,49,2319,2688,21018,4154,27860,18,341710,204614,,,,,2020-06-04
Piemonte,808,43,3705,4556,22292,3910,30758,24,331241,214551,,,,,2020-06-04
Puglia,131,9,827,967,3022,514,4503,4,125049,83870,,,,,2020-06-04
Basilicata,3,0,17,20,352,27,399,0,31096,30706,,,,,2020-06-04
Lombardia,2995,131,17098,20224,53046,16172,89442,237,777477,458782,,,,,2020-06-03
Calabria,20,0,90,110,951,97,1158,0,72237,69978,,,,,2020-06-03
Valle d'Aosta,9,0,4,13,1031,143,1187,0,15413,12084,,,,,2020-06-03
Sardegna,12,1,133,146,1080,131,1357,0,58605,50057,,,,,2020-06-03
Umbria,15,2,14,31,1324,76,1431,0,72001,51310,,,,,2020-06-03
Bolzano,13,3,104,120,2187,291,2598,0,67965,31800,,,,,2020-06-03
Abruzzo,112,3,621,736,2102,414,3252,3,78356,53555,,,,,2020-06-03
Friuli VG,39,2,192,233,2707,336,3276,0,138250,81683,,,,,2020-06-03
Sicilia,60,7,813,880,2292,275,3447,0,154873,131820,,,,,2020-06-03
Molise,1,2,124,127,287,22,436,0,15123,14439,,,,,2020-06-03
Trento,15,2,205,222,3748,463,4433,1,91021,49626,,,,,2020-06-03
Campania,206,4,659,869,3537,415,4821,12,208854,101664,,,,,2020-06-03
Marche,57,8,1245,1310,4438,987,6735,1,105679,66805,,,,,2020-06-03
Lazio,519,51,2248,2818,4188,747,7753,10,262461,211669,,,,,2020-06-03
Liguria,169,6,339,514,7764,1473,9751,17,110006,61006,,,,,2020-06-03
Toscana,76,25,872,973,8093,1055,10121,4,259167,183229,,,,,2020-06-03
Veneto,106,2,1279,1387,15856,1921,19164,2,695053,341333,,,,,2020-06-03
Emilia Romagna,342,50,2447,2839,20856,4147,27842,14,336630,202506,,,,,2020-06-03
Piemonte,841,44,3801,4686,22150,3898,30734,19,327206,212012,,,,,2020-06-03
Puglia,131,10,895,1036,2952,511,4499,1,122506,82041,,,,,2020-06-03
Basilicata,4,0,19,23,349,27,399,0,30708,29938,,,,,2020-06-03
Lombardia,3021,166,17068,20255,52807,16143,89205,187,766122,451502,,,,,2020-06-02
Calabria,20,1,91,112,949,97,1158,0,71617,69419,,,,,2020-06-02
Valle d'Aosta,10,0,3,13,1031,143,1187,0,15327,12027,,,,,2020-06-02
Sardegna,21,1,133,155,1071,131,1357,0,58224,49736,,,,,2020-06-02
Umbria,15,2,14,31,1324,76,1431,0,71769,51508,,,,,2020-06-02
Bolzano,13,3,104,120,2187,291,2598,0,67643,31610,,,,,2020-06-02
Abruzzo,113,6,624,743,2093,413,3249,4,77892,53279,,,,,2020-06-02
Friuli VG,40,2,202,244,2696,336,3276,2,136524,80795,,,,,2020-06-02
Sicilia,62,7,897,966,2206,275,3447,4,153417,130886,,,,,2020-06-02
Molise,3,2,128,133,281,22,436,0,14951,14278,,,,,2020-06-02
Trento,14,2,267,283,3686,463,4432,0,89787,49173,,,,,2020-06-02
Campania,236,7,647,890,3504,415,4809,3,206834,100269,,,,,2020-06-02
Marche,60,9,1257,1326,4421,987,6734,4,104968,66434,,,,,2020-06-02
Lazio,580,56,2211,2847,4155,741,7743,5,260102,209892,,,,,2020-06-02
Liguria,175,7,364,546,7720,1468,9734,15,109060,60631,,,,,2020-06-02
Toscana,85,25,901,1011,8053,1053,10117,10,257178,182335,,,,,2020-06-02
Veneto,103,5,1295,1403,15838,1921,19162,8,690267,340051,,,,,2020-06-02
Emilia Romagna,358,50,2504,2912,20780,4136,27828,19,333629,201267,,,,,2020-06-02
Piemonte,849,46,3933,4828,22003,3884,30715,57,325097,211174,,,,,2020-06-02
Puglia,134,11,906,1051,2939,508,4498,0,121460,81372,,,,,2020-06-02
Basilicata,4,0,20,24,348,27,399,0,30424,29664,,,,,2020-06-02
Lombardia,3085,167,17609,20861,52026,16131,89018,50,757446,447874,,,,,2020-06-01
Calabria,20,1,114,135,926,97,1158,0,70892,68633,,,,,2020-06-01
Valle d'Aosta,11,0,6,17,1027,143,1187,3,15230,11950,,,,,2020-06-01
Sardegna,23,1,137,161,1065,131,1357,1,57687,49354,,,,,2020-06-01
Umbria,15,2,14,31,1324,76,1431,0,70741,50790,,,,,2020-06-01
Bolzano,13,4,106,123,2184,291,2598,1,67121,31254,,,,,2020-06-01
Abruzzo,113,6,625,744,2093,408,3245,1,76924,52646,,,,,2020-06-01
Friuli VG,40,2,224,266,2673,335,3274,1,135431,80085,,,,,2020-06-01
Sicilia,65,8,894,967,2202,274,3443,0,151186,129103,,,,,2020-06-01
Molise,2,2,131,135,279,22,436,0,14819,14147,,,,,2020-06-01
Trento,14,3,276,293,3677,462,4432,2,89235,48853,,,,,2020-06-01
Campania,224,6,709,939,3454,413,4806,4,203858,99580,,,,,2020-06-01
Marche,63,9,1255,1327,4416,987,6730,0,103994,65848,,,,,2020-06-01
Lazio,594,56,2244,2894,4105,739,7738,10,257563,208081,,,,,2020-06-01
Liguria,191,7,413,611,7641,1467,9719,56,107787,60117,,,,,2020-06-01
Toscana,85,25,972,1082,7977,1048,10107,3,253845,180233,,,,,2020-06-01
Veneto,110,6,1352,1468,15768,1918,19154,2,675934,335650,,,,,2020-06-01
Emilia Romagna,383,54,2631,3068,20617,4124,27809,19,329358,198884,,,,,2020-06-01
Piemonte,904,54,4104,5062,21720,3876,30658,21,321476,209006,,,,,2020-06-01
Puglia,140,11,1004,1155,2837,506,4498,4,119650,80390,,,,,2020-06-01
Basilicata,4,0,24,28,344,27,399,0,29956,29196,,,,,2020-06-01
Lombardia,3131,170,17695,20996,51860,16112,88968,210,753874,445930,,,,,2020-05-31
Calabria,22,1,121,144,917,97,1158,0,70274,68015,,,,,2020-05-31
Valle d'Aosta,12,0,3,15,1026,143,1184,1,15203,11926,,,,,2020-05-31
Sardegna,33,2,150,185,1041,130,1356,0,57296,49016,,,,,2020-05-31
Umbria,15,2,14,31,1324,76,1431,0,70553,50271,,,,,2020-05-31
Bolzano,13,4,110,127,2179,291,2597,1,66247,30790,,,,,2020-05-31
Abruzzo,104,4,667,775,2064,405,3244,7,75652,50050,,,,,2020-05-31
Friuli VG,41,1,236,278,2662,333,3273,2,134378,80223,,,,,2020-05-31
Sicilia,65,7,914,986,2183,274,3443,1,150054,128717,,,,,2020-05-31
Molise,2,2,141,145,269,22,436,0,14631,13985,,,,,2020-05-31
Trento,13,3,288,304,3664,462,4430,1,88558,48665,,,,,2020-05-31
Campania,227,5,748,980,3410,412,4802,5,201543,98096,,,,,2020-05-31
Marche,62,9,1267,1338,4405,987,6730,3,103634,65617,,,,,2020-05-31
Lazio,730,57,2196,2983,4010,735,7728,13,255474,206235,,,,,2020-05-31
Liguria,195,8,466,669,7529,1465,9663,12,106363,59374,,,,,2020-05-31
Toscana,97,28,986,1111,7952,1041,10104,4,252090,179296,,,,,2020-05-31
Veneto,112,6,1382,1500,15734,1918,19152,6,669768,333834,,,,,2020-05-31
Emilia Romagna,393,57,2713,3163,20513,4114,27790,31,325482,197423,,,,,2020-05-31
Piemonte,973,58,4130,5161,21609,3867,30637,54,319133,207714,,,,,2020-05-31
Puglia,143,11,1023,1177,2813,504,4494,4,118652,79314,,,,,2020-05-31
Basilicata,4,0,25,29,343,27,399,0,29880,29130,,,,,2020-05-31
Lombardia,3307,172,18330,21809,50870,16079,88758,221,741447,438415,,,,,2020-05-30
Calabria,23,1,127,151,910,97,1158,0,69334,67075,,,,,2020-05-30
Valle d'Aosta,13,0,4,17,1023,143,1183,1,14972,11741,,,,,2020-05-30
Sardegna,34,2,150,186,1040,130,1356,0,56580,48432,,,,,2020-05-30
Umbria,16,1,14,31,1324,76,1431,0,70023,49760,,,,,2020-05-30
Bolzano,13,4,120,137,2168,291,2596,1,65405,30308,,,,,2020-05-30
Abruzzo,122,3,645,770,2063,404,3237,0,73301,50043,,,,,2020-05-30
Friuli VG,45,1,259,305,2633,333,3271,4,131976,78972,,,,,2020-05-30
Sicilia,67,7,925,999,2170,273,3442,2,148871,127725,,,,,2020-05-30
Molise,3,2,151,156,258,22,436,0,14371,13734,,,,,2020-05-30
Trento,13,3,350,366,3601,462,4429,1,86565,47908,,,,,2020-05-30
Campania,236,7,738,981,3405,411,4797,10,198033,95903,,,,,2020-05-30
Marche,66,9,1272,1347,4393,987,6727,4,102484,64947,,,,,2020-05-30
Lazio,769,58,2228,3055,3932,728,7715,6,253388,204232,,,,,2020-05-30
Liguria,186,9,586,781,7411,1459,9651,32,104892,58665,,,,,2020-05-30
Toscana,106,27,1033,1166,7897,1037,10100,12,249441,177686,,,,,2020-05-30
Veneto,120,7,1485,1612,15618,1916,19146,12,660151,331390,,,,,2020-05-30
Emilia Romagna,398,65,2816,3279,20373,4107,27759,20,321373,195492,,,,,2020-05-30
Piemonte,988,60,4242,5290,21435,3858,30583,82,315828,205102,,,,,2020-05-30
Puglia,150,12,1060,1222,2768,500,4490,8,116765,78458,,,,,2020-05-30
Basilicata,5,0,26,31,341,27,399,0,29421,28685,,,,,2020-05-30
Lombardia,3552,173,18958,22683,49842,16012,88537,354,727146,430863,,,,,2020-05-29
Calabria,25,1,133,159,902,97,1158,0,68131,65872,,,,,2020-05-29
Valle d'Aosta,12,0,7,19,1020,143,1182,0,14759,11572,,,,,2020-05-29
Sardegna,37,2,151,190,1036,130,1356,1,55831,47841,,,,,2020-05-29
Umbria,15,2,14,31,1324,76,1431,0,68773,48873,,,,,2020-05-29
Bolzano,17,5,132,154,2150,291,2595,0,64105,29680,,,,,2020-05-29
Abruzzo,122,3,645,770,2063,404,3237,0,73301,50043,,,,,2020-05-29
Friuli VG,45,2,276,323,2611,333,3267,5,130838,78151,,,,,2020-05-29
Sicilia,67,7,1063,1137,2031,272,3440,2,145979,125340,,,,,2020-05-29
Molise,3,2,157,162,252,22,436,1,14109,13506,,,,,2020-05-29
Trento,16,3,391,410,3556,462,4428,3,84805,47349,,,,,2020-05-29
Campania,236,7,743,986,3390,411,4787,10,193669,93464,,,,,2020-05-29
Marche,69,9,1274,1352,4385,986,6723,4,101389,64361,,,,,2020-05-29
Lazio,817,59,2287,3163,3825,721,7709,16,249267,201082,,,,,2020-05-29
Liguria,192,13,789,994,7173,1452,9619,14,102173,57376,,,,,2020-05-29
Toscana,111,31,1113,1255,7802,1031,10088,2,246052,175489,,,,,2020-05-29
Veneto,137,7,1705,1849,15379,1906,19134,9,645049,326795,,,,,2020-05-29
Emilia Romagna,429,76,3059,3564,20073,4102,27739,38,316909,193318,,,,,2020-05-29
Piemonte,1029,61,4568,5658,20992,3851,30501,56,309497,202227,,,,,2020-05-29
Puglia,158,12,1113,1283,2699,500,4482,1,114588,77211,,,,,2020-05-29
Basilicata,5,0,28,33,339,27,399,0,28909,28209,,,,,2020-05-29
Lombardia,3470,173,19270,22913,49296,15974,88183,382,713068,422568,,,,,2020-05-28
Calabria,31,1,138,170,892,96,1158,0,66956,64697,,,,,2020-05-28
Valle d'Aosta,16,0,7,23,1016,143,1182,1,14653,11487,,,,,2020-05-28
Sardegna,38,2,160,200,1025,130,1355,0,54587,46815,,,,,2020-05-28
Umbria,14,2,17,33,1323,75,1431,0,67458,47920,,,,,2020-05-28
Bolzano,16,5,136,157,2147,291,2595,2,63289,28809,,,,,2020-05-28
Abruzzo,128,3,693,824,2011,402,3237,2,71788,49084,,,,,2020-05-28
Friuli VG,51,1,284,336,2593,333,3262,7,126015,76369,,,,,2020-05-28
Sicilia,72,8,1065,1145,2021,272,3438,3,142516,122600,,,,,2020-05-28
Molise,3,2,158,163,250,22,435,1,13847,13266,,,,,2020-05-28
Trento,17,3,438,458,3505,462,4425,3,83018,46735,,,,,2020-05-28
Campania,260,6,746,1012,3355,410,4777,4,189068,90670,,,,,2020-05-28
Marche,79,13,1254,1346,4376,997,6719,1,100110,63611,,,,,2020-05-28
Lazio,1035,64,2306,3405,3580,708,7693,21,245993,198207,,,,,2020-05-28
Liguria,198,13,934,1145,7015,1445,9605,16,100625,56739,,,,,2020-05-28
Toscana,126,27,1227,1380,7677,1029,10086,4,242687,173406,,,,,2020-05-28
Veneto,148,9,1868,2025,15202,1898,19125,12,632124,323097,,,,,2020-05-28
Emilia Romagna,449,77,3224,3750,19857,4094,27701,74,310696,191112,,,,,2020-05-28
Piemonte,1058,64,4950,6072,20535,3838,30445,58,304358,199286,,,,,2020-05-28
Puglia,164,16,1215,1395,2590,496,4481,2,111946,75959,,,,,2020-05-28
Basilicata,6,0,28,34,338,27,399,0,28342,27952,,,,,2020-05-28
Lombardia,3626,175,20236,24037,47810,15954,87801,384,697561,12503,,,,,2020-05-27
Calabria,35,1,154,190,872,96,1158,1,65631,1117,,,,,2020-05-27
Valle d'Aosta,17,1,9,27,1011,143,1181,0,14459,197,,,,,2020-05-27
Sardegna,41,2,172,215,1010,130,1355,1,53294,1326,,,,,2020-05-27
Umbria,13,2,17,32,1324,75,1431,0,66219,1206,,,,,2020-05-27
Bolzano,27,5,139,171,2131,291,2593,0,62247,783,,,,,2020-05-27
Abruzzo,138,3,725,866,1969,400,3235,5,70473,1740,,,,,2020-05-27
Friuli VG,51,1,304,356,2568,331,3255,4,123063,1651,,,,,2020-05-27
Sicilia,73,10,1235,1318,1845,272,3435,5,140295,2613,,,,,2020-05-27
Molise,3,2,161,166,246,22,434,2,13629,177,,,,,2020-05-27
Trento,19,2,456,477,3483,462,4422,7,82269,1120,,,,,2020-05-27
Campania,275,6,865,1146,3221,406,4773,6,185724,5879,,,,,2020-05-27
Marche,90,13,1347,1450,4272,996,6718,0,98535,1250,,,,,2020-05-27
Lazio,1062,65,2361,3488,3483,701,7672,11,242287,3320,,,,,2020-05-27
Liguria,205,14,1050,1269,6882,1438,9589,39,98835,2157,,,,,2020-05-27
Toscana,132,31,1297,1460,7595,1027,10082,12,238667,3871,,,,,2020-05-27
Veneto,168,9,2110,2287,14931,1895,19113,8,616691,14439,,,,,2020-05-27
Emilia Romagna,459,78,3461,3998,19546,4083,27627,16,301568,3714,,,,,2020-05-27
Piemonte,1118,68,5278,6464,20095,3828,30387,73,298571,5098,,,,,2020-05-27
Puglia,170,17,1326,1513,2471,495,4479,10,109499,2626,,,,,2020-05-27
Basilicata,7,0,29,36,336,27,399,0,27734,537,,,,,2020-05-27
Lombardia,3622,183,20672,24477,47044,15896,87417,159,685058,405650,,,,,2020-05-26
Calabria,41,1,196,238,823,96,1157,0,64514,62255,,,,,2020-05-26
Valle d'Aosta,17,1,13,31,1007,143,1181,2,14262,11190,,,,,2020-05-26
Sardegna,41,2,181,224,1000,130,1354,0,51968,44663,,,,,2020-05-26
Umbria,12,2,28,42,1314,75,1431,1,65013,46044,,,,,2020-05-26
Bolzano,28,5,146,179,2123,291,2593,0,61464,28401,,,,,2020-05-26
Abruzzo,142,3,764,909,1921,400,3230,3,68733,46960,,,,,2020-05-26
Friuli VG,59,1,315,375,2547,329,3251,11,121412,73911,,,,,2020-05-26
Sicilia,83,10,1337,1430,1729,271,3430,3,137682,120206,,,,,2020-05-26
Molise,5,2,167,174,236,22,432,0,13452,12940,,,,,2020-05-26
Trento,24,3,486,513,3441,461,4415,10,81149,45926,,,,,2020-05-26
Campania,286,5,893,1184,3178,405,4767,12,179845,85780,,,,,2020-05-26
Marche,94,13,1468,1575,4147,996,6718,2,97285,61923,,,,,2020-05-26
Lazio,1083,59,2396,3538,3430,693,7661,18,238967,192591,,,,,2020-05-26
Liguria,223,19,1196,1438,6681,1431,9550,53,96678,54918,,,,,2020-05-26
Toscana,145,34,1343,1522,7527,1021,10070,3,234796,168150,,,,,2020-05-26
Veneto,177,11,2243,2431,14788,1886,19105,8,602252,312632,,,,,2020-05-26
Emilia Romagna,493,80,3573,4146,19389,4076,27611,24,297854,185125,,,,,2020-05-26
Piemonte,1162,70,5709,6941,19561,3812,30314,86,293473,193954,,,,,2020-05-26
Puglia,172,17,1350,1539,2436,494,4469,2,106873,73226,,,,,2020-05-26
Basilicata,8,0,28,36,336,27,399,0,27197,26807,,,,,2020-05-26
Lombardia,3721,196,21298,25215,46169,15874,87258,148,675882,400252,,,,,2020-05-25
Calabria,42,1,221,264,797,96,1157,0,63508,61249,,,,,2020-05-25
Valle d'Aosta,19,1,13,33,1003,143,1179,1,14175,11123,,,,,2020-05-25
Sardegna,49,3,179,231,994,129,1354,-2,51073,43924,,,,,2020-05-25
Umbria,15,2,29,46,1309,75,1430,0,63916,45268,,,,,2020-05-25
Bolzano,29,5,150,184,2118,291,2593,0,61075,28189,,,,,2020-05-25
Abruzzo,149,3,894,1046,1781,400,3227,1,67468,46146,,,,,2020-05-25
Friuli VG,62,1,323,386,2525,329,3240,4,120123,73079,,,,,2020-05-25
Sicilia,89,9,1335,1433,1724,270,3427,4,135261,118208,,,,,2020-05-25
Molise,5,2,170,177,233,22,432,0,13315,12819,,,,,2020-05-25
Trento,27,4,486,517,3430,458,4405,1,80454,45531,,,,,2020-05-25
Campania,287,7,919,1213,3137,405,4755,6,175466,82786,,,,,2020-05-25
Marche,95,13,1554,1662,4059,995,6716,2,96270,61347,,,,,2020-05-25
Lazio,1085,60,2409,3554,3401,688,7643,16,235840,190052,,,,,2020-05-25
Liguria,236,18,1302,1556,6516,1425,9497,17,94472,53791,,,,,2020-05-25
Toscana,152,37,1447,1636,7416,1015,10067,5,230273,165114,,,,,2020-05-25
Veneto,179,10,2389,2578,14641,1878,19097,11,590179,308128,,,,,2020-05-25
Emilia Romagna,514,82,3763,4359,19160,4068,27587,29,294181,183187,,,,,2020-05-25
Piemonte,1227,72,6197,7496,18934,3798,30228,48,288018,191129,,,,,2020-05-25
Puglia,190,15,1473,1678,2298,491,4467,9,104670,72042,,,,,2020-05-25
Basilicata,13,0,23,36,336,27,399,0,26634,25944,,,,,2020-05-25
Lombardia,4017,197,21400,25614,45656,15840,87110,285,670241,396992,,,,,2020-05-24
Calabria,43,1,231,275,786,96,1157,0,62952,60693,,,,,2020-05-24
Valle d'Aosta,23,1,8,32,1003,143,1178,1,14079,11035,,,,,2020-05-24
Sardegna,51,3,191,245,982,129,1356,0,50796,43661,,,,,2020-05-24
Umbria,15,2,36,53,1302,75,1430,0,63717,45131,,,,,2020-05-24
Bolzano,30,5,160,195,2107,291,2593,3,60573,27938,,,,,2020-05-24
Abruzzo,149,3,940,1092,1736,398,3226,5,66486,45516,,,,,2020-05-24
Friuli VG,62,1,349,412,2495,329,3236,3,118852,72104,,,,,2020-05-24
Sicilia,91,9,1353,1453,1701,269,3423,2,133249,117242,,,,,2020-05-24
Molise,6,2,175,183,227,22,432,1,13226,12751,,,,,2020-05-24
Trento,27,4,504,535,3412,457,4404,9,79788,45860,,,,,2020-05-24
Campania,311,8,949,1268,3076,405,4749,5,172106,80942,,,,,2020-05-24
Marche,101,13,1578,1692,4028,994,6714,13,95715,60949,,,,,2020-05-24
Lazio,1088,61,2420,3569,3374,684,7627,20,233498,187994,,,,,2020-05-24
Liguria,247,18,1359,1624,6437,1419,9480,53,93173,53230,,,,,2020-05-24
Toscana,148,38,1514,1700,7349,1013,10062,15,229135,164469,,,,,2020-05-24
Veneto,185,11,2464,2660,14557,1869,19086,17,582709,304944,,,,,2020-05-24
Emilia Romagna,519,83,3855,4457,19046,4055,27558,45,291876,182002,,,,,2020-05-24
Piemonte,1283,75,6345,7703,18694,3783,30180,43,285160,188716,,,,,2020-05-24
Puglia,204,17,1572,1793,2178,487,4458,10,103570,71032,,,,,2020-05-24
Basilicata,13,1,25,39,333,27,399,1,26111,25431,,,,,2020-05-24
Lombardia,4026,199,21405,25630,45355,15840,86825,441,658784,389648,,,,,2020-05-23
Calabria,43,1,244,288,773,96,1157,0,61892,59633,,,,,2020-05-23
Valle d'Aosta,23,2,10,35,999,143,1177,0,13828,10858,,,,,2020-05-23
Sardegna,58,6,223,287,940,129,1356,0,49675,42790,,,,,2020-05-23
Umbria,15,2,39,56,1300,74,1430,1,63009,44473,,,,,2020-05-23
Bolzano,35,5,174,214,2085,291,2590,0,59671,27549,,,,,2020-05-23
Abruzzo,156,4,1008,1168,1659,394,3221,1,65290,44680,,,,,2020-05-23
Friuli VG,63,1,395,459,2447,327,3233,6,116689,71043,,,,,2020-05-23
Sicilia,95,9,1408,1512,1640,269,3421,0,131913,116517,,,,,2020-05-23
Molise,8,2,179,189,220,22,431,5,13017,12552,,,,,2020-05-23
Trento,28,4,533,565,3374,456,4395,7,78185,45304,,,,,2020-05-23
Campania,295,10,968,1273,3067,404,4744,11,166692,79655,,,,,2020-05-23
Marche,100,15,1598,1713,3995,993,6701,4,94657,60232,,,,,2020-05-23
Lazio,1097,60,2424,3581,3350,676,7607,18,230743,185285,,,,,2020-05-23
Liguria,247,20,1467,1734,6279,1414,9427,38,91735,52664,,,,,2020-05-23
Toscana,157,40,1569,1766,7270,1011,10047,12,226046,162433,,,,,2020-05-23
Veneto,205,14,2622,2841,14363,1865,19069,10,572834,300799,,,,,2020-05-23
Emilia Romagna,524,84,3962,4570,18896,4047,27513,43,287382,179022,,,,,2020-05-23
Piemonte,1291,76,6658,8025,18341,3771,30137,60,281897,185963,,,,,2020-05-23
Puglia,215,17,1573,1805,2157,486,4448,8,101738,68485,,,,,2020-05-23
Basilicata,14,1,26,41,330,27,398,4,25511,24841,,,,,2020-05-23
Lombardia,4028,207,21698,25933,44667,15784,86384,293,641593,378934,,,,,2020-05-22
Calabria,47,1,254,302,759,96,1157,1,60847,58588,,,,,2020-05-22
Valle d'Aosta,22,2,19,43,991,143,1177,1,13531,10607,,,,,2020-05-22
Sardegna,58,6,242,306,922,128,1356,0,48189,41603,,,,,2020-05-22
Umbria,16,2,41,59,1296,74,1429,0,61696,43686,,,,,2020-05-22
Bolzano,34,5,185,224,2075,291,2590,3,58188,26585,,,,,2020-05-22
Abruzzo,157,4,1018,1179,1647,394,3220,8,63956,43904,,,,,2020-05-22
Friuli VG,68,2,415,485,2417,325,3227,12,114062,70035,,,,,2020-05-22
Sicilia,103,10,1406,1519,1634,268,3421,4,129431,114230,,,,,2020-05-22
Molise,8,2,174,184,220,22,426,3,12616,12173,,,,,2020-05-22
Trento,32,4,571,607,3326,455,4388,10,76001,43885,,,,,2020-05-22
Campania,312,9,971,1292,3037,404,4733,10,161825,76907,,,,,2020-05-22
Marche,101,15,1652,1768,3939,990,6697,8,93549,59673,,,,,2020-05-22
Lazio,1111,67,2457,3635,3285,669,7589,31,227090,182266,,,,,2020-05-22
Liguria,269,19,1620,1908,6074,1407,9389,45,89529,51771,,,,,2020-05-22
Toscana,162,42,1582,1786,7240,1009,10035,35,222505,160266,,,,,2020-05-22
Veneto,215,12,2796,3023,14182,1854,19059,21,559933,295343,,,,,2020-05-22
Emilia Romagna,552,89,4089,4730,18703,4037,27470,53,282857,176464,,,,,2020-05-22
Piemonte,1414,79,6959,8452,17868,3757,30077,87,276633,182970,,,,,2020-05-22
Puglia,233,17,1588,1838,2120,482,4440,27,99702,67562,,,,,2020-05-22
Basilicata,15,1,33,49,318,27,394,0,25045,24395,,,,,2020-05-22
Lombardia,4119,226,22370,26715,43649,15727,86091,316,622565,368046,,,,,2020-05-21
Calabria,47,1,278,326,734,96,1156,0,59724,57465,,,,,2020-05-21
Valle d'Aosta,26,1,16,43,990,143,1176,1,13261,10380,,,,,2020-05-21
Sardegna,64,12,242,318,911,127,1356,1,46795,40461,,,,,2020-05-21
Umbria,17,2,42,61,1294,74,1429,2,60471,42720,,,,,2020-05-21
Bolzano,50,5,195,250,2046,291,2587,0,57104,25999,,,,,2020-05-21
Abruzzo,175,5,1092,1272,1549,391,3212,7,62161,42768,,,,,2020-05-21
Friuli VG,72,2,504,578,2314,323,3215,6,111541,68882,,,,,2020-05-21
Sicilia,107,11,1404,1522,1627,268,3417,6,127348,112329,,,,,2020-05-21
Molise,8,2,184,194,207,22,423,1,12253,11819,,,,,2020-05-21
Trento,40,6,20,66,3857,455,4378,10,73849,42954,,,,,2020-05-21
Campania,312,9,1052,1373,2947,403,4723,9,155842,73912,,,,,2020-05-21
Marche,111,16,1705,1832,3867,990,6689,12,91885,58667,,,,,2020-05-21
Lazio,1110,68,2459,3637,3259,662,7558,25,222071,177749,,,,,2020-05-21
Liguria,283,22,1770,2075,5872,1397,9344,55,87011,50812,,,,,2020-05-21
Toscana,169,41,1667,1877,7119,1004,10000,18,218615,157388,,,,,2020-05-21
Veneto,237,15,3034,3286,13911,1841,19038,8,548573,290682,,,,,2020-05-21
Emilia Romagna,592,92,4242,4926,18466,4025,27417,53,278917,174485,,,,,2020-05-21
Piemonte,1479,83,7148,8710,17538,3742,29990,105,271286,179877,,,,,2020-05-21
Puglia,236,20,1583,1839,2096,478,4413,6,97589,67562,,,,,2020-05-21
Basilicata,15,1,44,60,307,27,394,1,24537,23903,,,,,2020-05-21
Lombardia,4281,231,22159,26671,43442,15662,85775,294,607863,359922,,,,,2020-05-20
Calabria,49,1,303,353,707,96,1156,3,58468,56209,,,,,2020-05-20
Valle d'Aosta,25,1,20,46,986,143,1175,0,12920,10079,,,,,2020-05-20
Sardegna,68,10,253,331,898,126,1355,1,45572,39460,,,,,2020-05-20
Umbria,25,2,39,66,1287,74,1427,0,59220,41748,,,,,2020-05-20
Bolzano,43,5,224,272,2024,291,2587,0,56310,25601,,,,,2020-05-20
Abruzzo,185,6,1126,1317,1499,389,3205,8,61123,42244,,,,,2020-05-20
Friuli VG,76,2,518,596,2291,322,3209,6,108671,67449,,,,,2020-05-20
Sicilia,118,11,1394,1523,1620,268,3411,8,123573,110205,,,,,2020-05-20
Molise,7,2,189,198,202,22,422,0,12158,11727,,,,,2020-05-20
Trento,39,6,81,126,3787,455,4368,10,72031,42140,,,,,2020-05-20
Campania,318,12,1112,1442,2871,401,4714,7,150764,71118,,,,,2020-05-20
Marche,125,16,1833,1974,3716,987,6677,2,90093,57604,,,,,2020-05-20
Lazio,1119,74,2593,3786,3100,647,7533,28,217849,173903,,,,,2020-05-20
Liguria,310,22,1846,2178,5725,1386,9289,32,85140,49819,,,,,2020-05-20
Toscana,178,45,1894,2117,6867,998,9982,14,214299,154671,,,,,2020-05-20
Veneto,255,16,3261,3532,13666,1832,19030,33,536798,285786,,,,,2020-05-20
Emilia Romagna,626,96,4376,5098,18258,4008,27364,50,274362,171903,,,,,2020-05-20
Piemonte,1513,96,7542,9151,17016,3718,29885,158,264624,177088,,,,,2020-05-20
Puglia,242,21,1639,1902,2027,478,4407,11,95895,66164,,,,,2020-05-20
Basilicata,22,1,50,73,293,27,393,0,23986,23376,,,,,2020-05-20
Lombardia,4426,244,22621,27291,42593,15597,85481,462,596355,353579,,,,,2020-05-19
Calabria,50,2,330,382,676,95,1153,2,57310,55270,,,,,2020-05-19
Valle d'Aosta,26,1,22,49,983,143,1175,1,12663,9862,,,,,2020-05-19
Sardegna,71,9,261,341,887,126,1354,1,44413,38503,,,,,2020-05-19
Umbria,25,2,39,66,1287,74,1427,3,57822,40651,,,,,2020-05-19
Bolzano,46,6,256,308,1988,291,2587,5,55526,25263,,,,,2020-05-19
Abruzzo,188,6,1195,1389,1419,389,3197,4,58945,41162,,,,,2020-05-19
Friuli VG,76,2,522,600,2283,320,3203,5,105656,65476,,,,,2020-05-19
Sicilia,125,12,1387,1524,1611,268,3403,8,122040,109195,,,,,2020-05-19
Molise,9,2,201,212,188,22,422,0,11592,11354,,,,,2020-05-19
Trento,42,8,154,204,3699,455,4358,7,70691,42125,,,,,2020-05-19
Campania,330,17,1171,1518,2790,399,4707,12,147225,69264,,,,,2020-05-19
Marche,144,17,1967,2128,3561,986,6675,-3,89985,56668,,,,,2020-05-19
Lazio,1124,74,2588,3786,3079,640,7505,20,213877,171353,,,,,2020-05-19
Liguria,338,22,1904,2264,5617,1376,9257,66,83593,49038,,,,,2020-05-19
Toscana,190,56,2077,2323,6653,992,9968,7,209161,151093,,,,,2020-05-19
Veneto,259,18,3477,3754,13423,1820,18997,47,523800,280629,,,,,2020-05-19
Emilia Romagna,670,99,4561,5330,17987,3997,27314,47,268200,168367,,,,,2020-05-19
Piemonte,1579,96,7960,9635,16413,3679,29727,108,258489,173201,,,,,2020-05-19
Puglia,247,22,1672,1941,1982,473,4396,10,93834,64779,,,,,2020-05-19
Basilicata,26,1,57,84,282,27,393,1,23347,22767,,,,,2020-05-19
Lombardia,4482,252,22339,27073,42403,15543,85019,175,581437,343213,,,,,2020-05-18
Calabria,53,2,346,401,655,95,1151,0,56167,54333,,,,,2020-05-18
Valle d'Aosta,30,0,30,60,971,143,1174,1,12327,9595,,,,,2020-05-18
Sardegna,72,10,298,380,847,126,1353,0,43387,37684,,,,,2020-05-18
Umbria,24,2,51,77,1274,73,1424,0,56279,39512,,,,,2020-05-18
Bolzano,52,6,249,307,1984,291,2582,1,54861,24930,,,,,2020-05-18
Abruzzo,191,6,1216,1413,1392,388,3193,7,57897,40345,,,,,2020-05-18
Friuli VG,81,3,537,621,2257,320,3198,7,104874,65184,,,,,2020-05-18
Sicilia,137,13,1389,1539,1589,267,3395,7,118859,106277,,,,,2020-05-18
Molise,9,2,206,217,183,22,422,11,11514,11285,,,,,2020-05-18
Trento,41,8,199,248,3650,453,4351,13,70173,41383,,,,,2020-05-18
Campania,342,17,1314,1673,2623,399,4695,11,143478,67155,,,,,2020-05-18
Marche,156,17,2142,2315,3379,984,6678,11,89085,55988,,,,,2020-05-18
Lazio,1137,73,2616,3826,3031,628,7485,39,209472,167859,,,,,2020-05-18
Liguria,360,23,1956,2339,5485,1367,9191,32,81485,47984,,,,,2020-05-18
Toscana,197,66,2310,2573,6399,989,9961,13,205201,148580,,,,,2020-05-18
Veneto,263,22,3719,4004,13143,1803,18950,9,513021,275851,,,,,2020-05-18
Emilia Romagna,708,105,4712,5525,17756,3986,27267,35,263888,166240,,,,,2020-05-18
Piemonte,1589,99,8186,9874,16113,3632,29619,72,253479,170556,,,,,2020-05-18
Puglia,254,22,1719,1995,1920,471,4386,7,91901,63403,,,,,2020-05-18
Basilicata,29,1,63,93,272,27,392,0,22581,22016,,,,,2020-05-18
Lombardia,4480,255,22695,27430,41895,15519,84844,326,576359,340164,,,,,2020-05-17
Calabria,56,2,364,422,634,95,1151,0,55304,53470,,,,,2020-05-17
Valle d'Aosta,31,0,37,68,962,143,1173,0,12169,9469,,,,,2020-05-17
Sardegna,76,10,319,405,823,125,1353,1,42249,36736,,,,,2020-05-17
Umbria,25,2,51,78,1273,73,1424,2,55956,39272,,,,,2020-05-17
Bolzano,50,5,259,314,1977,290,2581,3,54428,24677,,,,,2020-05-17
Abruzzo,193,6,1223,1422,1379,385,3186,8,57217,39788,,,,,2020-05-17
Friuli VG,80,3,571,654,2218,319,3191,8,104056,64558,,,,,2020-05-17
Sicilia,145,13,1397,1555,1566,267,3388,6,117426,105074,,,,,2020-05-17
Molise,11,2,203,216,173,22,411,1,11085,10892,,,,,2020-05-17
Trento,41,8,252,301,3584,453,4338,12,69659,41383,,,,,2020-05-17
Campania,342,17,1337,1696,2592,396,4684,16,139787,63039,,,,,2020-05-17
Marche,151,18,2396,2565,3118,984,6667,25,88656,55667,,,,,2020-05-17
Lazio,1150,74,2686,3910,2914,622,7446,50,206166,164779,,,,,2020-05-17
Liguria,360,24,2072,2456,5348,1355,9159,48,80154,47381,,,,,2020-05-17
Toscana,214,67,2521,2802,6162,984,9948,35,204022,148060,,,,,2020-05-17
Veneto,273,22,3746,4041,13106,1794,18941,13,506588,272938,,,,,2020-05-17
Emilia Romagna,721,111,4824,5656,17603,3973,27232,50,261106,163117,,,,,2020-05-17
Piemonte,1620,101,8518,10239,15696,3612,29547,64,249371,168295,,,,,2020-05-17
Puglia,263,21,1733,2017,1892,470,4379,5,91035,62886,,,,,2020-05-17
Basilicata,29,1,74,104,261,27,392,2,22167,21627,,,,,2020-05-17
Lombardia,4521,268,22890,27679,41389,15450,84518,399,,333243,,,,,2020-05-16
Calabria,56,2,416,474,582,95,1151,7,,52257,,,,,2020-05-16
Valle d'Aosta,33,0,42,75,956,142,1173,1,,9181,,,,,2020-05-16
Sardegna,75,10,330,415,812,125,1352,4,,35933,,,,,2020-05-16
Umbria,25,2,54,81,1268,73,1422,0,,38663,,,,,2020-05-16
Bolzano,48,5,290,343,1945,290,2578,0,,24316,,,,,2020-05-16
Abruzzo,195,7,1221,1423,1372,383,3178,30,,38681,,,,,2020-05-16
Friuli VG,79,3,598,680,2184,319,3183,8,,63251,,,,,2020-05-16
Sicilia,159,12,1488,1659,1458,265,3382,8,,103103,,,,,2020-05-16
Molise,8,2,205,215,173,22,410,3,,10666,,,,,2020-05-16
Trento,44,8,293,345,3528,453,4326,8,,39613,,,,,2020-05-16
Campania,351,16,1343,1710,2562,396,4668,14,,61574,,,,,2020-05-16
Marche,154,17,2486,2657,3003,982,6642,23,,54804,,,,,2020-05-16
Lazio,1156,76,2790,4022,2758,616,7396,32,,161405,,,,,2020-05-16
Liguria,369,26,2138,2533,5232,1346,9111,51,,46304,,,,,2020-05-16
Toscana,234,66,2643,2943,5991,979,9913,30,,145946,,,,,2020-05-16
Veneto,290,20,3852,4162,12983,1783,18928,39,,269003,,,,,2020-05-16
Emilia Romagna,740,112,5000,5852,17370,3960,27182,72,,163067,,,,,2020-05-16
Piemonte,1562,100,9040,10702,15187,3594,29483,137,,165849,,,,,2020-05-16
Puglia,272,22,1810,2104,1807,463,4374,8,,61942,,,,,2020-05-16
Basilicata,29,1,83,113,250,27,390,1,,20966,,,,,2020-05-16
Lombardia,4705,276,22765,27746,40962,15411,84119,299,550405,325071,,,,,2020-05-15
Calabria,56,2,447,505,544,95,1144,1,52701,50847,,,,,2020-05-15
Valle d'Aosta,37,0,40,77,953,142,1172,6,11413,8814,,,,,2020-05-15
Sardegna,75,10,376,461,762,125,1348,3,39844,34864,,,,,2020-05-15
Umbria,25,2,63,90,1259,73,1422,2,53801,37660,,,,,2020-05-15
Bolzano,50,5,304,359,1929,290,2578,0,52939,23969,,,,,2020-05-15
Abruzzo,205,6,1243,1454,1313,381,3148,12,54028,37587,,,,,2020-05-15
Friuli VG,80,3,658,741,2116,318,3175,14,100400,62319,,,,,2020-05-15
Sicilia,198,11,1551,1760,1351,263,3374,8,112929,101487,,,,,2020-05-15
Molise,8,2,217,227,158,22,407,4,10468,10281,,,,,2020-05-15
Trento,53,9,344,406,3461,451,4318,3,63700,38273,,,,,2020-05-15
Campania,341,17,1378,1736,2522,396,4654,15,131544,59162,,,,,2020-05-15
Marche,178,18,2599,2795,2847,977,6619,16,84351,53813,,,,,2020-05-15
Lazio,1173,79,2836,4088,2672,604,7364,73,197599,157880,,,,,2020-05-15
Liguria,385,31,2187,2603,5121,1336,9060,65,76012,45307,,,,,2020-05-15
Toscana,238,67,2863,3168,5739,976,9883,24,197365,144237,,,,,2020-05-15
Veneto,311,24,4104,4439,12688,1762,18889,44,484639,264091,,,,,2020-05-15
Emilia Romagna,763,114,5124,6001,17166,3943,27110,54,253497,160622,,,,,2020-05-15
Piemonte,1593,108,9412,11113,14676,3557,29346,137,239507,161854,,,,,2020-05-15
Puglia,285,23,1873,2181,1724,461,4366,9,87687,60613,,,,,2020-05-15
Basilicata,33,1,86,120,242,27,389,0,20851,20359,,,,,2020-05-15
Lombardia,4818,297,24841,29956,38568,15296,83820,522,538243,318289,,,,,2020-05-14
Calabria,59,2,463,524,524,95,1143,3,51050,49196,,,,,2020-05-14
Valle d'Aosta,38,0,42,80,945,141,1166,3,11100,8537,,,,,2020-05-14
Sardegna,76,10,379,465,755,125,1345,0,38034,33526,,,,,2020-05-14
Umbria,26,1,65,92,1255,73,1420,1,52247,36495,,,,,2020-05-14
Bolzano,54,7,319,380,1908,290,2578,3,52015,23487,,,,,2020-05-14
Abruzzo,215,6,1261,1482,1275,379,3136,9,52860,36844,,,,,2020-05-14
Friuli VG,149,2,619,770,2074,317,3161,5,97000,60177,,,,,2020-05-14
Sicilia,203,12,1639,1854,1249,263,3366,12,111137,99900,,,,,2020-05-14
Molise,10,1,218,229,152,22,403,2,10227,10052,,,,,2020-05-14
Trento,66,9,430,505,3362,448,4315,3,60843,36359,,,,,2020-05-14
Campania,387,19,1359,1765,2480,394,4639,9,127938,57684,,,,,2020-05-14
Marche,189,18,2697,2904,2725,974,6603,15,82840,53030,,,,,2020-05-14
Lazio,1178,79,2839,4096,2600,595,7291,41,192917,153894,,,,,2020-05-14
Liguria,408,35,2217,2660,5006,1329,8995,65,74248,44390,,,,,2020-05-14
Toscana,269,68,3051,3388,5498,973,9859,30,193182,141430,,,,,2020-05-14
Veneto,342,26,4350,4718,12384,1743,18845,32,474488,260706,,,,,2020-05-14
Emilia Romagna,861,122,5318,6301,16825,3930,27056,77,248591,158371,,,,,2020-05-14
Piemonte,1775,116,10000,11891,13825,3493,29209,151,232682,158112,,,,,2020-05-14
Puglia,296,24,1933,2253,1643,461,4357,9,85577,59815,,,,,2020-05-14
Basilicata,34,1,92,127,235,27,389,0,20285,19789,,,,,2020-05-14
Lombardia,5007,307,24718,30032,38081,15185,83298,394,524163,310896,,,,,2020-05-13
Calabria,64,1,486,551,496,93,1140,2,49787,47960,,,,,2020-05-13
Valle d'Aosta,38,0,55,93,929,141,1163,3,10777,8254,,,,,2020-05-13
Sardegna,78,10,403,491,734,120,1345,1,36710,32449,,,,,2020-05-13
Umbria,36,4,66,106,1241,72,1419,0,50731,35313,,,,,2020-05-13
Bolzano,56,7,350,413,1872,290,2575,3,51181,23120,,,,,2020-05-13
Abruzzo,214,7,1268,1489,1263,375,3127,12,51361,35898,,,,,2020-05-13
Friuli VG,92,2,685,779,2061,316,3156,8,94600,58936,,,,,2020-05-13
Sicilia,212,13,1664,1889,1203,262,3354,11,107991,96860,,,,,2020-05-13
Molise,9,1,221,231,148,22,401,15,10062,9773,,,,,2020-05-13
Trento,76,9,488,573,3293,446,4312,9,57997,34662,,,,,2020-05-13
Campania,402,19,1394,1815,2421,394,4630,15,124370,56390,,,,,2020-05-13
Marche,211,20,2782,3013,2604,971,6588,20,80850,52041,,,,,2020-05-13
Lazio,1224,83,2928,4235,2438,577,7250,38,188632,150097,,,,,2020-05-13
Liguria,430,35,2253,2718,4898,1314,8930,67,72174,43272,,,,,2020-05-13
Toscana,284,72,3207,3563,5302,964,9829,27,189026,138465,,,,,2020-05-13
Veneto,364,30,4626,5020,12081,1712,18813,31,463154,257017,,,,,2020-05-13
Emilia Romagna,1165,123,5214,6502,16572,3905,26979,50,243883,155476,,,,,2020-05-13
Piemonte,1858,122,10511,12491,13107,3460,29058,169,224788,154504,,,,,2020-05-13
Puglia,310,27,1985,2322,1566,460,4348,11,83713,58383,,,,,2020-05-13
Basilicata,42,1,88,131,231,27,389,2,19678,19186,,,,,2020-05-13
Lombardia,5222,322,25131,30675,37113,15116,82904,1033,513244,305152,,,,,2020-05-12
Calabria,65,1,502,568,477,93,1138,4,48420,46593,,,,,2020-05-12
Valle d'Aosta,45,0,59,104,916,140,1160,2,10415,7956,,,,,2020-05-12
Sardegna,77,11,418,506,718,120,1344,1,35476,31351,,,,,2020-05-12
Umbria,41,4,64,109,1239,71,1419,7,49249,34207,,,,,2020-05-12
Bolzano,56,7,374,437,1845,290,2572,0,50381,22731,,,,,2020-05-12
Abruzzo,222,8,1318,1548,1197,370,3115,8,50295,35241,,,,,2020-05-12
Friuli VG,96,2,703,801,2034,313,3148,10,93051,58395,,,,,2020-05-12
Sicilia,234,15,1662,1911,1171,261,3343,4,105017,94034,,,,,2020-05-12
Basilicata,47,1,92,140,220,27,387,1,19100,18608,,,,,2020-05-12
Puglia,334,31,2056,2421,1460,456,4337,10,81492,57060,,,,,2020-05-12
Campania,414,20,1443,1877,2345,393,4615,13,121253,55406,,,,,2020-05-12
Marche,230,24,2954,3208,2391,969,6568,25,79414,51176,,,,,2020-05-12
Lazio,1258,84,2931,4273,2373,566,7212,22,185085,147010,,,,,2020-05-12
Liguria,447,35,2297,2779,4783,1301,8863,31,70159,42200,,,,,2020-05-12
Toscana,307,72,3462,3841,5002,959,9802,15,184851,136285,,,,,2020-05-12
Veneto,393,33,4764,5190,11906,1686,18782,41,454189,253374,,,,,2020-05-12
Emilia Romagna,1384,136,5281,6801,16243,3885,26929,53,239178,153074,,,,,2020-05-12
Piemonte,1900,136,11148,13184,12277,3428,28889,113,218071,149386,,,,,2020-05-12
Trento,80,9,578,667,3191,445,4303,6,55334,33082,,,,,2020-05-12
Molise,13,1,212,226,138,22,386,3,9981,9582,,,,,2020-05-12
Lombardia,5397,341,24673,30411,36406,15054,81871,364,492642,292603,,,,,2020-05-11
Calabria,64,1,503,568,473,93,1134,2,47265,45438,,,,,2020-05-11
Valle d'Aosta,44,1,62,107,912,139,1158,1,10063,7651,,,,,2020-05-11
Sardegna,84,10,417,511,712,120,1343,3,34641,30582,,,,,2020-05-11
Umbria,40,4,64,108,1233,71,1412,1,47474,33027,,,,,2020-05-11
Bolzano,63,7,377,447,1835,290,2572,3,50019,22500,,,,,2020-05-11
Abruzzo,231,9,1369,1609,1132,366,3107,4,48903,34428,,,,,2020-05-11
Friuli VG,96,3,731,830,1996,312,3138,8,90860,57130,,,,,2020-05-11
Sicilia,271,16,1775,2062,1020,257,3339,12,103134,92609,,,,,2020-05-11
Basilicata,46,1,95,142,217,27,386,1,18266,17774,,,,,2020-05-11
Puglia,340,32,2172,2544,1332,451,4327,14,79737,55794,,,,,2020-05-11
Campania,436,23,1450,1909,2301,392,4602,14,119042,54822,,,,,2020-05-11
Marche,277,28,2922,3227,2352,964,6543,10,77830,50206,,,,,2020-05-11
Lazio,1266,83,2945,4294,2334,562,7190,25,181398,143970,,,,,2020-05-11
Liguria,484,38,2322,2844,4695,1293,8832,44,68814,41535,,,,,2020-05-11
Toscana,347,77,3649,4073,4764,950,9787,13,179469,132464,,,,,2020-05-11
Veneto,400,38,5022,5460,11615,1666,18741,19,445905,250175,,,,,2020-05-11
Emilia Romagna,1537,141,5362,7040,15969,3867,26876,80,234619,151040,,,,,2020-05-11
Piemonte,2021,135,11182,13338,12038,3400,28776,111,213783,147318,,,,,2020-05-11
Trento,84,11,640,735,3119,443,4297,2,53398,31970,,,,,2020-05-11
Molise,11,0,218,229,132,22,383,13,9390,9247,,,,,2020-05-11
Lombardia,5428,348,24414,30190,36331,14986,81507,282,485134,287330,,,,,2020-05-10
Calabria,66,2,528,596,445,91,1132,3,46111,44284,,,,,2020-05-10
Valle d'Aosta,46,2,65,113,905,139,1157,5,9833,7467,,,,,2020-05-10
Sardegna,83,10,422,515,705,120,1340,6,34046,30086,,,,,2020-05-10
Umbria,42,6,65,113,1227,71,1411,4,46923,32713,,,,,2020-05-10
Bolzano,61,8,390,459,1820,290,2569,2,49571,22265,,,,,2020-05-10
Abruzzo,233,10,1428,1671,1073,359,3103,17,48110,33876,,,,,2020-05-10
Friuli VG,98,3,750,851,1969,310,3130,6,89449,56205,,,,,2020-05-10
Sicilia,273,16,1780,2069,1002,256,3327,14,102403,91748,,,,,2020-05-10
Basilicata,45,1,97,143,215,27,385,3,17916,17424,,,,,2020-05-10
Puglia,343,34,2292,2669,1196,448,4313,27,78399,54781,,,,,2020-05-10
Campania,435,20,1460,1915,2282,391,4588,12,114819,53475,,,,,2020-05-10
Marche,284,30,2937,3251,2322,960,6533,40,76367,49194,,,,,2020-05-10
Lazio,1265,84,2937,4286,2322,557,7165,32,178569,141233,,,,,2020-05-10
Liguria,481,41,2378,2900,4607,1281,8788,50,67322,40751,,,,,2020-05-10
Toscana,350,78,3719,4147,4685,942,9774,29,178208,131788,,,,,2020-05-10
Veneto,408,37,5146,5591,11474,1657,18722,51,439522,247617,,,,,2020-05-10
Emilia Romagna,1562,150,5479,7191,15760,3845,26796,77,231637,149276,,,,,2020-05-10
Piemonte,2024,137,11489,13650,11648,3367,28665,116,210370,145131,,,,,2020-05-10
Trento,82,10,694,786,3068,441,4295,3,52039,30808,,,,,2020-05-10
Molise,9,0,209,218,130,22,370,23,9164,9008,,,,,2020-05-10
Lombardia,5535,330,24397,30262,36039,14924,81225,502,477765,282817,,,,,2020-05-09
Calabria,68,2,542,612,427,90,1129,3,45071,42993,,,,,2020-05-09
Valle d'Aosta,45,3,70,118,895,139,1152,1,9443,7130,,,,,2020-05-09
Sardegna,87,11,452,550,665,119,1334,4,33330,29503,,,,,2020-05-09
Umbria,45,6,60,111,1225,71,1407,1,45574,31679,,,,,2020-05-09
Bolzano,55,9,409,473,1804,290,2567,9,48858,21969,,,,,2020-05-09
Abruzzo,246,10,1420,1676,1055,355,3086,8,47190,33013,,,,,2020-05-09
Friuli VG,101,3,765,869,1947,308,3124,8,88384,55319,,,,,2020-05-09
Sicilia,277,17,1786,2080,977,256,3313,12,101548,90885,,,,,2020-05-09
Basilicata,45,1,99,145,210,27,382,0,17433,16941,,,,,2020-05-09
Puglia,344,33,2352,2729,1114,443,4286,30,76643,54181,,,,,2020-05-09
Campania,415,26,1524,1965,2223,388,4576,14,110811,52593,,,,,2020-05-09
Marche,285,32,2913,3230,2305,958,6493,23,73965,47827,,,,,2020-05-09
Lazio,1277,82,2986,4345,2235,553,7133,47,174448,137428,,,,,2020-05-09
Liguria,501,42,2439,2982,4480,1276,8738,15,64926,39600,,,,,2020-05-09
Toscana,364,79,4005,4448,4360,937,9745,24,174596,129382,,,,,2020-05-09
Veneto,435,40,5402,5877,11151,1643,18671,53,432114,244930,,,,,2020-05-09
Emilia Romagna,1604,155,5642,7401,15491,3827,26719,121,227366,146642,,,,,2020-05-09
Piemonte,2010,143,11781,13934,11284,3331,28549,181,205800,141515,,,,,2020-05-09
Trento,87,10,733,830,3024,438,4292,7,50278,30354,,,,,2020-05-09
Molise,8,0,197,205,120,22,347,20,8691,8375,,,,,2020-05-09
Lombardia,5702,400,25881,31983,33901,14839,80723,634,466287,277106,,,,,2020-05-08
Calabria,73,2,544,619,417,90,1126,1,43980,41902,,,,,2020-05-08
Valle d'Aosta,45,2,76,123,889,139,1151,1,9280,6999,,,,,2020-05-08
Sardegna,90,10,453,553,658,119,1330,6,32219,28519,,,,,2020-05-08
Umbria,47,6,66,119,1216,71,1406,1,44223,30704,,,,,2020-05-08
Bolzano,78,9,415,502,1767,289,2558,6,47908,21572,,,,,2020-05-08
Abruzzo,250,10,1453,1713,1014,351,3078,6,46103,32619,,,,,2020-05-08
Friuli VG,105,2,804,911,1897,308,3116,9,82902,52784,,,,,2020-05-08
Sicilia,310,19,1798,2127,921,253,3301,13,98711,88497,,,,,2020-05-08
Basilicata,48,2,102,152,204,26,382,-1,16777,16285,,,,,2020-05-08
Puglia,349,33,2351,2733,1080,443,4256,11,74724,53194,,,,,2020-05-08
Campania,418,28,1566,2012,2164,386,4562,21,105399,51402,,,,,2020-05-08
Marche,303,38,2897,3238,2278,954,6470,18,72504,47092,,,,,2020-05-08
Lazio,1278,84,2966,4328,2209,549,7086,52,169499,133674,,,,,2020-05-08
Liguria,517,46,2613,3176,4282,1265,8723,78,63531,39145,,,,,2020-05-08
Toscana,399,84,4109,4592,4199,930,9721,38,170296,126752,,,,,2020-05-08
Veneto,831,79,5277,6187,10804,1627,18618,65,420949,240535,,,,,2020-05-08
Emilia Romagna,1680,163,5887,7730,15071,3797,26598,111,221866,144009,,,,,2020-05-08
Piemonte,2013,140,11954,14107,10956,3305,28368,233,201183,138830,,,,,2020-05-08
Trento,94,11,767,872,2975,438,4285,2,48220,29188,,,,,2020-05-08
Molise,6,0,178,184,121,22,327,22,8502,8177,,,,,2020-05-08
Lombardia,5848,480,25687,32015,33329,14745,80089,720,455294,262964,,,,,2020-05-07
Calabria,81,2,550,633,403,89,1125,3,42854,40806,,,,,2020-05-07
Valle d'Aosta,49,2,79,130,881,139,1150,4,8939,6702,,,,,2020-05-07
Sardegna,90,9,484,583,622,119,1324,5,31064,27540,,,,,2020-05-07
Umbria,47,9,85,141,1194,70,1405,1,42788,29708,,,,,2020-05-07
Bolzano,87,11,453,551,1715,286,2552,9,47091,21284,,,,,2020-05-07
Abruzzo,263,12,1495,1770,954,348,3072,25,45021,32186,,,,,2020-05-07
Friuli VG,109,2,816,927,1872,308,3107,13,82012,51123,,,,,2020-05-07
Sicilia,349,21,1757,2127,910,251,3288,7,95695,85674,,,,,2020-05-07
Basilicata,48,2,105,155,202,26,383,-16,16272,15780,,,,,2020-05-07
Puglia,355,35,2410,2800,1004,441,4245,49,72796,51638,,,,,2020-05-07
Campania,415,27,1697,2139,2023,379,4541,9,101025,50463,,,,,2020-05-07
Marche,328,41,2878,3247,2257,948,6452,31,71017,46258,,,,,2020-05-07
Lazio,1291,89,2968,4348,2143,543,7034,39,165340,130351,,,,,2020-05-07
Liguria,525,57,2666,3248,4143,1254,8645,94,61446,38071,,,,,2020-05-07
Toscana,437,91,4188,4716,4052,915,9683,26,166062,124295,,,,,2020-05-07
Veneto,872,87,5575,6534,10430,1589,18553,74,410212,236281,,,,,2020-05-07
Emilia Romagna,1726,173,6112,8011,14710,3766,26487,108,217039,141468,,,,,2020-05-07
Piemonte,2147,150,12172,14469,10384,3282,28135,196,194584,134567,,,,,2020-05-07
Trento,99,11,800,910,2935,438,4283,3,46500,28486,,,,,2020-05-07
Molise,8,0,162,170,113,22,305,1,8237,7912,,,,,2020-05-07
Lombardia,6079,480,25194,31753,33005,14611,79369,764,439806,262964,,,,,2020-05-06
Calabria,87,3,554,644,389,89,1122,3,41828,39780,,,,,2020-05-06
Valle d'Aosta,50,3,74,127,880,139,1146,3,8640,6461,,,,,2020-05-06
Sardegna,91,11,521,623,577,119,1319,1,29966,26598,,,,,2020-05-06
Umbria,55,9,107,171,1163,70,1404,4,41328,28712,,,,,2020-05-06
Bolzano,99,11,469,579,1678,286,2543,1,46228,20872,,,,,2020-05-06
Abruzzo,285,11,1495,1791,915,341,3047,22,43803,31502,,,,,2020-05-06
Friuli VG,115,3,844,962,1826,306,3094,9,79429,50698,,,,,2020-05-06
Sicilia,359,25,1817,2201,830,250,3281,14,92999,83908,,,,,2020-05-06
Basilicata,47,3,122,172,202,25,399,3,16103,15619,,,,,2020-05-06
Puglia,365,36,2502,2903,855,438,4196,26,70944,68760,,,,,2020-05-06
Campania,433,25,1882,2340,1816,376,4532,14,96548,49478,,,,,2020-05-06
Marche,353,42,2841,3236,2242,943,6421,29,69037,45026,,,,,2020-05-06
Lazio,1351,91,2991,4433,2024,538,6995,81,160894,125897,,,,,2020-05-06
Liguria,548,59,2699,3306,4002,1243,8551,76,59693,37177,,,,,2020-05-06
Toscana,462,92,4534,5088,3670,899,9657,26,161553,121066,,,,,2020-05-06
Veneto,902,90,5797,6789,10122,1568,18479,77,399806,231469,,,,,2020-05-06
Emilia Romagna,1816,176,6399,8391,14251,3737,26379,104,211652,138871,,,,,2020-05-06
Piemonte,2147,150,12561,14858,9834,3247,27939,165,188057,131269,,,,,2020-05-06
Trento,116,13,853,982,2861,437,4280,19,44719,26161,,,,,2020-05-06
Molise,9,0,170,179,103,22,304,3,7896,7604,,,,,2020-05-06
Lombardia,6201,509,30382,37092,27124,14389,78605,500,425290,255292,,,,,2020-05-05
Calabria,92,4,554,650,381,88,1119,1,40509,38461,,,,,2020-05-05
Valle d'Aosta,56,3,51,110,894,139,1143,0,8484,6342,,,,,2020-05-05
Sardegna,94,9,539,642,557,119,1318,1,28867,25631,,,,,2020-05-05
Umbria,56,11,109,176,1154,70,1400,6,39998,27822,,,,,2020-05-05
Bolzano,99,11,502,612,1644,286,2542,1,45264,20561,,,,,2020-05-05
Abruzzo,289,11,1509,1809,881,335,3025,25,42489,30835,,,,,2020-05-05
Friuli VG,120,4,860,984,1798,303,3085,9,78510,50135,,,,,2020-05-05
Sicilia,367,26,1809,2202,818,247,3267,12,91306,82079,,,,,2020-05-05
Basilicata,50,3,124,177,194,25,396,10,15476,15028,,,,,2020-05-05
Puglia,384,39,2516,2939,798,433,4170,17,69128,67238,,,,,2020-05-05
Campania,408,25,2097,2530,1619,369,4518,20,93068,48733,,,,,2020-05-05
Marche,387,42,2790,3219,2237,936,6392,29,67256,44045,,,,,2020-05-05
Lazio,1315,91,2964,4370,2010,534,6914,67,157307,122541,,,,,2020-05-05
Liguria,583,68,2776,3427,3816,1232,8475,63,57622,36150,,,,,2020-05-05
Toscana,484,111,4595,5190,3552,889,9631,30,157260,118265,,,,,2020-05-05
Veneto,926,98,6092,7116,9741,1545,18402,29,390952,227579,,,,,2020-05-05
Emilia Romagna,1917,191,6573,8681,13889,3705,26275,100,206166,136310,,,,,2020-05-05
Piemonte,2307,155,12861,15323,9235,3216,27774,152,181316,126685,,,,,2020-05-05
Trento,126,15,900,1041,2787,433,4261,3,42870,25137,,,,,2020-05-05
Molise,9,1,167,177,102,22,301,0,7528,7252,,,,,2020-05-05
Lombardia,6414,532,30361,37307,26504,14294,78105,577,418835,251661,,,,,2020-05-04
Calabria,93,4,577,674,356,88,1118,4,39438,37390,,,,,2020-05-04
Valle d'Aosta,74,2,34,110,894,139,1143,1,8271,6200,,,,,2020-05-04
Sardegna,91,9,553,653,545,119,1317,-2,28052,24926,,,,,2020-05-04
Umbria,56,13,112,181,1143,70,1394,0,39044,27152,,,,,2020-05-04
Bolzano,103,10,523,636,1621,284,2541,5,44673,20333,,,,,2020-05-04
Abruzzo,301,15,1521,1837,831,332,3000,4,41108,30047,,,,,2020-05-04
Friuli VG,130,4,916,1050,1727,299,3076,4,75421,48250,,,,,2020-05-04
Sicilia,376,27,1799,2202,809,244,3255,15,87166,79336,,,,,2020-05-04
Basilicata,50,3,120,173,188,25,386,0,14901,14455,,,,,2020-05-04
Puglia,397,39,2509,2945,779,429,4153,9,67167,65789,,,,,2020-05-04
Campania,438,24,2249,2711,1421,366,4498,14,90543,48275,,,,,2020-05-04
Marche,389,44,2773,3206,2225,932,6363,44,65398,42838,,,,,2020-05-04
Lazio,1335,95,2955,4385,1938,524,6847,38,153293,120095,,,,,2020-05-04
Liguria,606,72,2830,3508,3683,1221,8412,53,56092,35443,,,,,2020-05-04
Toscana,512,107,4660,5279,3441,881,9601,38,152447,115065,,,,,2020-05-04
Veneto,955,101,6178,7234,9611,1528,18373,55,383660,223968,,,,,2020-05-04
Emilia Romagna,1968,199,6817,8984,13525,3666,26175,159,200427,133329,,,,,2020-05-04
Piemonte,2391,161,13010,15562,8874,3186,27622,192,176078,123801,,,,,2020-05-04
Trento,135,17,1013,1165,2663,430,4258,11,42061,24500,,,,,2020-05-04
Molise,9,1,168,178,101,22,301,0,7328,7057,,,,,2020-05-04
Lombardia,6609,532,29785,36926,26371,14231,77528,526,410857,247176,,,,,2020-05-03
Calabria,95,4,603,702,324,88,1114,2,38835,36874,,,,,2020-05-03
Valle d'Aosta,74,2,33,109,895,138,1142,6,8100,6046,,,,,2020-05-03
Sardegna,92,10,587,689,511,119,1319,4,27737,24662,,,,,2020-05-03
Umbria,58,13,112,183,1143,68,1394,0,38823,26973,,,,,2020-05-03
Bolzano,109,11,545,665,1590,281,2536,1,44240,20166,,,,,2020-05-03
Abruzzo,300,16,1552,1868,798,330,2996,32,40699,29788,,,,,2020-05-03
Friuli VG,131,6,950,1087,1688,297,3072,13,74990,48041,,,,,2020-05-03
Sicilia,383,29,1791,2203,795,242,3240,27,85955,78409,,,,,2020-05-03
Basilicata,48,3,143,194,167,25,386,6,14210,14210,,,,,2020-05-03
Puglia,410,40,2505,2955,765,424,4144,11,66443,64781,,,,,2020-05-03
Campania,455,30,2241,2726,1394,364,4484,25,86498,47027,,,,,2020-05-03
Marche,400,43,2755,3198,2194,927,6319,21,64412,42281,,,,,2020-05-03
Lazio,1346,95,2944,4385,1916,508,6809,53,150912,117796,,,,,2020-05-03
Liguria,627,68,2856,3551,3599,1209,8359,47,54492,34613,,,,,2020-05-03
Toscana,513,112,4703,5328,3363,872,9563,38,150914,114354,,,,,2020-05-03
Veneto,955,103,6241,7299,9503,1516,18318,94,378202,220598,,,,,2020-05-03
Emilia Romagna,1997,197,6851,9045,13329,3642,26016,166,197075,131047,,,,,2020-05-03
Piemonte,2496,169,12973,15638,8640,3152,27430,251,172208,121176,,,,,2020-05-03
Trento,136,17,1094,1247,2571,429,4247,66,41095,24085,,,,,2020-05-03
Molise,8,1,172,181,98,22,301,0,7075,6808,,,,,2020-05-03
Lombardia,6529,545,29593,36667,26146,14189,77002,533,,243383,,,,,2020-05-02
Calabria,100,4,609,713,311,88,1112,0,,35975,,,,,2020-05-02
Valle d'Aosta,70,3,25,98,901,137,1136,3,,5931,,,,,2020-05-02
Sardegna,86,13,631,730,466,119,1315,2,,24065,,,,,2020-05-02
Umbria,60,13,123,196,1130,68,1394,1,,26463,,,,,2020-05-02
Bolzano,113,10,580,703,1553,279,2535,7,,20036,,,,,2020-05-02
Abruzzo,303,16,1560,1879,758,327,2964,16,,29308,,,,,2020-05-02
Friuli VG,131,5,973,1109,1655,295,3059,18,,47259,,,,,2020-05-02
Sicilia,396,30,1760,2186,787,240,3213,19,,77590,,,,,2020-05-02
Basilicata,48,4,139,191,164,25,380,2,,13722,,,,,2020-05-02
Puglia,416,39,2499,2954,757,422,4133,34,,63782,,,,,2020-05-02
Campania,470,27,2224,2721,1376,362,4459,15,,45955,,,,,2020-05-02
Marche,399,46,2760,3205,2177,916,6298,23,,41156,,,,,2020-05-02
Lazio,1370,96,2986,4452,1807,497,6756,84,,114761,,,,,2020-05-02
Liguria,647,68,2883,3598,3519,1195,8312,186,,34037,,,,,2020-05-02
Toscana,519,118,4728,5365,3297,863,9525,80,,112437,,,,,2020-05-02
Veneto,970,108,6353,7431,9291,1502,18224,126,,216997,,,,,2020-05-02
Emilia Romagna,2033,196,7094,9323,12913,3614,25850,206,,128005,,,,,2020-05-02
Piemonte,2550,178,12991,15719,8334,3126,27179,495,,118814,,,,,2020-05-02
Trento,138,19,1125,1282,2474,425,4181,49,,23380,,,,,2020-05-02
Molise,9,1,172,182,98,21,301,1,,6808,,,,,2020-05-02
Lombardia,6628,563,29282,36473,26136,13860,76469,737,390644,236822,,,,,2020-05-01
Calabria,105,3,619,727,299,86,1112,4,37054,35101,,,,,2020-05-01
Valle d'Aosta,72,3,17,92,904,137,1133,5,7769,5818,,,,,2020-05-01
Sardegna,84,12,648,744,452,117,1313,18,26242,23442,,,,,2020-05-01
Umbria,60,13,131,204,1121,68,1393,1,37762,26285,,,,,2020-05-01
Bolzano,112,11,634,757,1493,278,2528,10,42903,19705,,,,,2020-05-01
Abruzzo,297,16,1598,1911,713,324,2948,18,39385,29024,,,,,2020-05-01
Friuli VG,131,6,978,1115,1632,294,3041,16,71013,45566,,,,,2020-05-01
Sicilia,399,30,1742,2171,786,237,3194,28,82860,77490,,,,,2020-05-01
Basilicata,49,4,140,193,160,25,378,11,13269,13269,,,,,2020-05-01
Puglia,428,39,2480,2947,731,421,4099,27,64292,62702,,,,,2020-05-01
Campania,478,29,2246,2753,1332,359,4444,21,79940,44975,,,,,2020-05-01
Marche,413,44,2754,3211,2153,911,6275,28,61241,40123,,,,,2020-05-01
Lazio,1372,105,2969,4446,1744,482,6672,56,143804,111988,,,,,2020-05-01
Liguria,666,68,2784,3518,3424,1184,8126,133,51199,32794,,,,,2020-05-01
Toscana,520,124,4729,5373,3218,854,9445,93,146456,111349,,,,,2020-05-01
Veneto,977,110,6692,7779,8840,1479,18098,138,362459,212706,,,,,2020-05-01
Emilia Romagna,2112,197,7175,9484,12581,3579,25644,208,188264,125636,,,,,2020-05-01
Piemonte,2503,181,12878,15562,8025,3097,26684,395,162568,114786,,,,,2020-05-01
Trento,146,19,1128,1293,2416,423,4132,16,37838,22602,,,,,2020-05-01
Molise,17,1,172,190,89,21,300,2,6463,6450,,,,,2020-05-01
Lombardia,6834,605,28772,36211,25749,13772,75732,598,376943,229880,,,,,2020-04-30
Calabria,105,6,629,740,282,86,1108,6,35903,33950,,,,,2020-04-30
Valle d'Aosta,76,4,9,89,902,137,1128,4,7631,5647,,,,,2020-04-30
Sardegna,87,16,641,744,435,116,1295,5,24754,22358,,,,,2020-04-30
Umbria,68,16,149,233,1092,67,1392,1,36459,25317,,,,,2020-04-30
Bolzano,126,13,663,802,1441,275,2518,11,41297,19178,,,,,2020-04-30
Abruzzo,306,16,1593,1915,695,320,2930,7,37996,28351,,,,,2020-04-30
Friuli VG,109,11,1050,1170,1566,289,3025,15,67930,43691,,,,,2020-04-30
Sicilia,408,33,1716,2157,774,235,3166,26,79669,74541,,,,,2020-04-30
Basilicata,49,4,139,192,150,25,367,1,12774,12774,,,,,2020-04-30
Puglia,439,42,2468,2949,708,415,4072,43,62460,61439,,,,,2020-04-30
Campania,484,29,2260,2773,1291,359,4423,13,76108,44233,,,,,2020-04-30
Marche,465,48,2697,3210,2131,906,6247,37,59488,39145,,,,,2020-04-30
Lazio,1417,115,2936,4468,1707,441,6616,71,137596,107497,,,,,2020-04-30
Liguria,676,69,2806,3551,3275,1167,7993,104,48762,31520,,,,,2020-04-30
Toscana,546,126,4912,5584,2926,842,9352,60,141849,108596,,,,,2020-04-30
Veneto,1012,114,7021,8147,8354,1459,17960,135,349227,206347,,,,,2020-04-30
Emilia Romagna,2146,206,7211,9563,12322,3551,25436,259,182857,122430,,,,,2020-04-30
Piemonte,2621,199,12673,15493,7730,3066,26289,428,156534,110157,,,,,2020-04-30
Trento,158,21,1191,1370,2328,418,4116,47,36534,21622,,,,,2020-04-30
Molise,17,1,172,190,87,21,298,1,6446,6228,,,,,2020-04-30
Lombardia,7120,634,28368,36122,25333,13679,75134,786,365895,223952,,,,,2020-04-29
Calabria,107,6,640,753,263,86,1102,5,34914,32961,,,,,2020-04-29
Valle d'Aosta,78,5,52,135,852,137,1124,5,7181,5337,,,,,2020-04-29
Sardegna,87,17,657,761,413,116,1290,5,23299,21071,,,,,2020-04-29
Umbria,77,16,168,261,1064,66,1391,12,34937,24079,,,,,2020-04-29
Bolzano,119,14,712,845,1388,274,2507,9,40218,18844,,,,,2020-04-29
Abruzzo,309,19,1648,1976,632,315,2923,24,36614,27703,,,,,2020-04-29
Friuli VG,134,12,1081,1227,1498,285,3010,15,66769,42902,,,,,2020-04-29
Sicilia,415,34,1696,2145,763,232,3140,20,75360,71301,,,,,2020-04-29
Basilicata,51,4,139,194,147,25,366,0,11331,11331,,,,,2020-04-29
Puglia,449,47,2431,2927,692,410,4029,49,60334,59801,,,,,2020-04-29
Campania,518,31,2233,2782,1269,359,4410,30,73094,43449,,,,,2020-04-29
Marche,640,52,2655,3347,1964,899,6210,35,55905,37877,,,,,2020-04-29
Lazio,1445,130,2960,4535,1579,431,6545,78,133503,103435,,,,,2020-04-29
Liguria,697,70,2809,3576,3161,1152,7889,117,47220,30669,,,,,2020-04-29
Toscana,576,139,4948,5663,2802,827,9292,61,137482,106150,,,,,2020-04-29
Veneto,1042,114,7213,8369,8019,1437,17825,117,337656,200737,,,,,2020-04-29
Emilia Romagna,2527,226,9109,11862,9803,3512,25177,263,176865,118881,,,,,2020-04-29
Piemonte,2637,202,12682,15521,7337,3003,25861,411,151266,106179,,,,,2020-04-29
Trento,165,22,1276,1463,2190,416,4069,44,35008,20944,,,,,2020-04-29
Molise,17,1,175,193,83,21,297,0,5910,5857,,,,,2020-04-29
Lombardia,7280,655,27809,35744,25029,13575,74348,869,351423,216526,,,,,2020-04-28
Calabria,113,6,645,764,248,85,1097,1,33755,31802,,,,,2020-04-28
Valle d'Aosta,81,5,123,209,775,135,1119,8,6897,5069,,,,,2020-04-28
Sardegna,96,18,658,772,404,109,1285,2,22116,20053,,,,,2020-04-28
Umbria,80,17,178,275,1039,65,1379,9,33881,23263,,,,,2020-04-28
Bolzano,136,15,759,910,1316,272,2498,2,39130,18567,,,,,2020-04-28
Abruzzo,312,21,1657,1990,599,310,2899,25,35356,27054,,,,,2020-04-28
Friuli VG,136,13,1090,1239,1478,278,2995,18,64151,41273,,,,,2020-04-28
Sicilia,428,34,1681,2143,745,232,3120,35,73008,68729,,,,,2020-04-28
Basilicata,56,7,142,205,136,25,366,0,10889,10889,,,,,2020-04-28
Puglia,448,51,2420,2919,654,407,3980,22,58496,57574,,,,,2020-04-28
Campania,544,33,2225,2802,1220,358,4380,31,70566,42690,,,,,2020-04-28
Marche,666,58,2610,3334,1948,893,6175,48,54313,36650,,,,,2020-04-28
Lazio,1468,132,2962,4562,1491,414,6467,75,128664,98968,,,,,2020-04-28
Liguria,718,81,2772,3571,3060,1141,7772,130,45719,29794,,,,,2020-04-28
Toscana,619,144,5133,5896,2524,811,9231,52,133617,103891,,,,,2020-04-28
Veneto,1067,120,7414,8601,7699,1408,17708,129,328218,196864,,,,,2020-04-28
Emilia Romagna,2574,228,9201,12003,9439,3472,24914,252,172589,116624,,,,,2020-04-28
Piemonte,2701,202,12603,15506,7008,2936,25450,352,144531,102514,,,,,2020-04-28
Trento,182,22,1361,1565,2048,412,4025,30,33839,20539,,,,,2020-04-28
Molise,18,1,176,195,81,21,297,1,5776,5538,,,,,2020-04-28
Lombardia,7525,680,27236,35441,24589,13449,73479,590,342850,211523,,,,,2020-04-27
Calabria,114,6,662,782,231,83,1096,7,31787,29834,,,,,2020-04-27
Valle d'Aosta,86,7,142,235,743,133,1111,5,6551,4873,,,,,2020-04-27
Sardegna,97,19,660,776,398,109,1283,3,21395,19424,,,,,2020-04-27
Umbria,90,16,181,287,1018,65,1370,2,32823,22492,,,,,2020-04-27
Bolzano,150,16,774,940,1286,270,2496,15,38640,18423,,,,,2020-04-27
Abruzzo,328,23,1679,2030,545,299,2874,15,34176,26443,,,,,2020-04-27
Friuli VG,130,13,1115,1258,1448,271,2977,60,60940,39330,,,,,2020-04-27
Sicilia,440,35,1648,2123,731,231,3085,30,70650,66749,,,,,2020-04-27
Basilicata,57,7,153,217,124,25,366,0,10364,10364,,,,,2020-04-27
Puglia,449,51,2412,2912,641,405,3958,10,56976,55897,,,,,2020-04-27
Campania,541,37,2299,2877,1120,352,4349,18,68727,42463,,,,,2020-04-27
Marche,667,58,2585,3310,1933,884,6127,16,52765,35617,,,,,2020-04-27
Lazio,1464,143,2955,4562,1433,397,6392,83,124769,95719,,,,,2020-04-27
Liguria,754,83,2743,3580,2934,1128,7642,154,44039,28739,,,,,2020-04-27
Toscana,671,154,5158,5983,2401,795,9179,32,129048,100869,,,,,2020-04-27
Veneto,1099,123,7638,8860,7375,1344,17579,108,320027,192751,,,,,2020-04-27
Emilia Romagna,2640,247,9338,12225,9006,3431,24662,212,164979,111041,,,,,2020-04-27
Piemonte,2830,214,12464,15508,6712,2878,25098,278,139348,99144,,,,,2020-04-27
Trento,201,23,1483,1707,1881,407,3995,101,33152,20199,,,,,2020-04-27
Molise,20,1,179,200,75,21,296,0,5656,5423,,,,,2020-04-27
Lombardia,3355,345,64184,67884,92567,17414,177865,7339,143887,33978,177865,1780305,2850943,42684,2020-10-29
Valle d'Aosta,120,7,1457,1584,1235,162,2981,178,2635,346,2981,25235,40095,781,2020-10-29
Calabria,134,7,2573,2714,1798,113,4625,225,1174,3451,4625,266077,268987,2741,2020-10-29
PA Bolzano,193,15,4009,4217,2962,306,7485,298,7485,0,7485,117659,227707,2566,2020-10-29
PA Trento,109,9,1503,1621,6470,435,8526,173,4842,3684,8526,112836,283240,3103,2020-10-29
Sardegna,322,39,5205,5566,3035,207,8808,282,3345,5463,8808,221404,260726,3460,2020-10-29
Umbria,260,41,5270,5571,3277,119,8967,694,2917,6050,8967,169837,290964,4584,2020-10-29
Friuli Venezia Giulia,152,34,3922,4108,5115,387,9610,468,8609,1001,9610,225536,526798,5659,2020-10-29
Abruzzo,331,26,5087,5444,3690,540,9674,482,7200,2474,9674,174707,280591,3910,2020-10-29
Basilicata,74,7,1175,1256,684,47,1987,86,670,1317,1987,99620,100470,1004,2020-10-29
Marche,247,39,4850,5136,6950,1009,13095,686,13015,80,13095,183944,314006,3915,2020-10-29
Sicilia,839,115,11791,12745,6605,472,19822,789,12621,7201,19822,472930,669376,7226,2020-10-29
Liguria,907,50,6979,7936,16863,1742,26541,1018,18879,7662,26541,224168,431053,6067,2020-10-29
Toscana,956,137,22877,23970,13678,1310,38958,1966,31190,7768,38958,706557,1056864,15594,2020-10-29
Lazio,1786,168,27758,29712,11002,1173,41887,1995,14932,26955,41887,1132105,1386496,25164,2020-10-29
Campania,1297,164,36243,37704,10537,644,48885,3103,46299,2586,48885,622408,919318,17735,2020-10-29
Veneto,759,97,22770,23626,25247,2371,51244,2109,24522,26722,51244,890507,2288598,12729,2020-10-29
Emilia-Romagna,1054,123,18536,19713,27724,4601,52038,1545,39481,12557,52038,835830,1553171,21860,2020-10-29
Piemonte,2381,146,25364,27891,32807,4332,65030,2585,31834,33196,65030,609925,997507,12787,2020-10-29
Puglia,669,78,9255,10002,6361,706,17069,716,4849,12220,17069,386874,544675,7083,2020-10-29
Molise,19,4,768,791,675,32,1498,94,1448,50,1498,58031,61905,800,2020-10-29
Lombardia,8481,706,25979,35166,24398,13325,72889,920,337797,208471,,,,,2020-04-26
Calabria,118,8,671,797,212,80,1089,1,30853,28900,,,,,2020-04-26
Valle d'Aosta,82,7,165,254,721,131,1106,6,6135,4624,,,,,2020-04-26
Sardegna,95,20,668,783,388,109,1280,9,21101,19162,,,,,2020-04-26
Umbria,91,17,188,296,1008,64,1368,2,32569,22320,,,,,2020-04-26
Bolzano,138,14,842,994,1218,269,2481,5,37431,17895,,,,,2020-04-26
Abruzzo,324,24,1720,2068,496,295,2859,27,33820,26184,,,,,2020-04-26
Friuli VG,129,13,1106,1248,1405,264,2917,14,59681,38202,,,,,2020-04-26
Sicilia,445,33,1629,2107,720,228,3055,35,70104,65689,,,,,2020-04-26
Basilicata,57,7,155,219,122,25,366,5,10077,10077,,,,,2020-04-26
Trento,199,24,1459,1682,1807,405,3894,56,32142,19902,,,,,2020-04-26
Campania,536,45,2343,2924,1062,345,4331,32,67218,42279,,,,,2020-04-26
Marche,668,58,2582,3308,1924,879,6111,53,52063,35107,,,,,2020-04-26
Lazio,1442,161,2970,4573,1347,389,6309,85,121677,93811,,,,,2020-04-26
Liguria,748,82,2650,3480,2894,1114,7488,187,42607,27852,,,,,2020-04-26
Toscana,677,158,5234,6069,2300,778,9147,132,127394,99751,,,,,2020-04-26
Veneto,1097,124,7917,9138,7018,1315,17471,80,316361,183513,,,,,2020-04-26
Emilia Romagna,2695,245,9401,12341,8723,3386,24450,241,161928,109192,,,,,2020-04-26
Piemonte,2866,214,12439,15519,6478,2823,24820,394,135142,96977,,,,,2020-04-26
Puglia,464,48,2425,2937,612,399,3948,36,55992,55397,,,,,2020-04-26
Molise,20,1,179,200,75,21,296,4,5567,5334,,,,,2020-04-26
Lombardia,8489,724,25260,34473,24227,13269,71969,713,326940,202827,,,,,2020-04-25
Calabria,125,7,679,811,197,80,1088,9,29959,28006,,,,,2020-04-25
Valle d'Aosta,83,6,224,313,657,130,1100,0,5966,4694,,,,,2020-04-25
Sardegna,96,18,680,794,374,103,1271,14,20351,18480,,,,,2020-04-25
Umbria,95,18,184,297,1006,63,1366,3,31939,21842,,,,,2020-04-25
Bolzano,141,14,880,1035,1176,265,2476,20,36608,17573,,,,,2020-04-25
Abruzzo,323,26,1712,2061,478,293,2832,29,33624,25959,,,,,2020-04-25
Friuli VG,122,15,947,1084,1556,263,2903,21,58375,37211,,,,,2020-04-25
Sicilia,452,33,1787,2272,524,224,3020,39,68251,64892,,,,,2020-04-25
Basilicata,58,7,153,218,118,25,361,1,9792,9792,,,,,2020-04-25
Trento,202,27,1515,1744,1694,400,3838,62,30661,19394,,,,,2020-04-25
Campania,543,55,2337,2935,1023,341,4299,17,64521,41399,,,,,2020-04-25
Marche,689,58,2525,3272,1912,874,6058,30,50996,34256,,,,,2020-04-25
Lazio,1421,183,2957,4561,1276,387,6224,92,118354,90582,,,,,2020-04-25
Liguria,759,83,2591,3433,2775,1093,7301,128,41125,26898,,,,,2020-04-25
Toscana,687,166,5293,6146,2109,760,9015,138,125495,98753,,,,,2020-04-25
Veneto,1105,129,8198,9432,6671,1288,17391,162,306977,186426,,,,,2020-04-25
Emilia Romagna,2718,246,9383,12347,8515,3347,24209,239,156883,105628,,,,,2020-04-25
Piemonte,2937,238,12327,15502,6157,2767,24426,604,131107,93325,,,,,2020-04-25
Puglia,469,48,2402,2919,602,391,3912,31,54628,53500,,,,,2020-04-25
Molise,19,1,178,198,73,21,292,5,5191,5089,,,,,2020-04-25
Lombardia,8791,756,24821,34368,23782,13106,71256,1091,314298,196406,,,,,2020-04-24
Calabria,123,7,691,821,178,80,1079,10,28764,26811,,,,,2020-04-24
Valle d'Aosta,88,7,259,354,617,129,1100,4,5262,4454,,,,,2020-04-24
Sardegna,95,19,690,804,351,102,1257,3,19889,18050,,,,,2020-04-24
Umbria,94,19,209,322,979,62,1363,1,30524,20733,,,,,2020-04-24
Bolzano,148,16,929,1093,1100,263,2456,21,35062,17024,,,,,2020-04-24
Abruzzo,327,28,1724,2079,438,286,2803,18,32397,25397,,,,,2020-04-24
Friuli VG,136,16,1168,1320,1304,258,2882,24,55502,35547,,,,,2020-04-24
Sicilia,461,32,1827,2320,443,218,2981,55,65165,63626,,,,,2020-04-24
Basilicata,59,7,163,229,107,24,360,4,9026,9026,,,,,2020-04-24
Trento,224,28,1575,1827,1560,389,3776,49,29779,19250,,,,,2020-04-24
Campania,524,44,2375,2943,1003,336,4282,44,61331,40053,,,,,2020-04-24
Marche,705,61,2507,3273,1890,865,6028,76,49163,33113,,,,,2020-04-24
Lazio,1396,184,2912,4492,1256,384,6132,78,114317,86545,,,,,2020-04-24
Liguria,760,87,2590,3437,2660,1076,7173,124,39563,26040,,,,,2020-04-24
Toscana,738,159,5236,6133,2002,742,8877,97,121336,96180,,,,,2020-04-24
Veneto,1159,130,8390,9679,6306,1244,17229,348,296896,181473,,,,,2020-04-24
Piemonte,2918,257,12216,15391,5732,2699,23822,682,125300,89392,,,,,2020-04-24
Emilia Romagna,2807,264,9438,12509,8158,3303,23970,247,151505,102495,,,,,2020-04-24
Puglia,496,51,2386,2933,565,383,3881,42,52472,51517,,,,,2020-04-24
Molise,19,1,180,200,67,20,287,3,4805,4718,,,,,2020-04-24
Lombardia,190,27,8124,8341,69828,16736,94905,135,89120,5785,94905,675013,1126332,11505,2020-07-10
Calabria,4,0,23,27,1062,97,1186,1,1159,27,1186,101548,103582,997,2020-07-10
Valle d'Aosta,4,0,1,5,1045,146,1196,0,1079,117,1196,14342,19327,81,2020-07-10
Sardegna,3,0,7,10,1228,134,1372,1,1360,12,1372,77452,91395,866,2020-07-10
Umbria,4,0,4,8,1360,80,1448,1,1434,14,1448,69774,104428,786,2020-07-10
PA Bolzano,6,0,80,86,2280,292,2658,5,2658,0,2658,44223,89711,634,2020-07-10
Sicilia,6,0,118,124,2691,283,3098,0,2749,349,3098,187482,231767,1916,2020-07-10
Abruzzo,26,0,122,148,2709,464,3321,3,3112,209,3321,75231,113388,883,2020-07-10
Friuli Venezia Giulia,2,0,76,78,2910,345,3333,1,3327,6,3333,112349,209161,2353,2020-07-10
Molise,0,0,15,15,407,23,445,0,444,1,445,23177,24295,146,2020-07-10
Puglia,13,0,59,72,3922,546,4540,4,2084,2456,4540,134139,198088,2018,2020-07-10
PA Trento,1,0,26,27,4447,405,4879,3,3380,1499,4879,66521,131980,1226,2020-07-10
Marche,4,0,164,168,5644,987,6799,1,6799,0,6799,88956,147083,805,2020-07-10
Lazio,197,13,691,901,6530,844,8275,23,6063,2212,8275,297217,362312,2470,2020-07-10
Liguria,25,1,238,264,8203,1558,10025,15,8483,1542,10025,85633,160464,1563,2020-07-10
Toscana,9,2,319,330,8865,1121,10316,2,10095,221,10316,245794,366018,2685,2020-07-10
Veneto,14,3,377,394,16936,2039,19369,11,19278,91,19369,433661,1048535,8346,2020-07-10
Emilia-Romagna,96,10,1007,1113,23440,4269,28822,53,28050,772,28822,322910,540614,4182,2020-07-10
Piemonte,193,9,873,1075,26300,4110,31485,10,26303,5182,31485,275135,444443,2766,2020-07-10
Campania,44,0,193,237,4093,432,4762,7,4701,61,4762,148627,299725,1508,2020-07-10
Basilicata,3,0,2,5,373,27,405,0,401,4,405,41193,41973,217,2020-07-10
Lombardia,9192,790,23891,33873,23352,12940,70165,1073,302715,190451,,,,,2020-04-23
Calabria,129,7,687,823,170,76,1069,9,27869,26187,,,,,2020-04-23
Valle d'Aosta,91,9,363,463,506,127,1096,1,5227,4133,,,,,2020-04-23
Sardegna,90,20,707,817,339,98,1254,7,17844,16094,,,,,2020-04-23
Umbria,100,19,236,355,946,61,1362,5,29011,19627,,,,,2020-04-23
Bolzano,141,17,1336,1494,680,261,2435,19,33994,16442,,,,,2020-04-23
Abruzzo,322,31,1747,2100,405,280,2785,52,31187,24751,,,,,2020-04-23
Friuli VG,138,18,979,1135,1467,256,2858,41,52918,34057,,,,,2020-04-23
Sicilia,476,34,1791,2301,412,213,2926,43,62150,62150,,,,,2020-04-23
Basilicata,61,7,161,229,103,24,356,2,8511,8511,,,,,2020-04-23
Trento,234,29,1608,1871,1474,382,3727,81,28240,18656,,,,,2020-04-23
Campania,539,47,2392,2978,928,332,4238,53,58324,38679,,,,,2020-04-23
Marche,727,71,2432,3230,1865,857,5952,28,47662,31673,,,,,2020-04-23
Lazio,1385,186,2915,4486,1193,375,6054,79,111073,26298,,,,,2020-04-23
Liguria,783,91,2592,3466,2536,1047,7049,131,37842,25045,,,,,2020-04-23
Toscana,791,168,5212,6171,1886,723,8780,80,118177,94426,,,,,2020-04-23
Veneto,1189,140,8596,9925,5750,1206,16881,143,288075,177154,,,,,2020-04-23
Piemonte,3039,261,11852,15152,5358,2630,23140,401,117970,84648,,,,,2020-04-23
Emilia Romagna,2889,266,9690,12845,7609,3269,23723,289,146146,99714,,,,,2020-04-23
Puglia,536,55,2345,2936,531,372,3839,109,50410,49403,,,,,2020-04-23
Molise,19,1,178,198,66,20,284,0,4564,4478,,,,,2020-04-23
Lombardia,9692,817,23733,34242,22110,12740,69092,1161,290699,,,,,,2020-04-22
Calabria,128,7,686,821,163,76,1060,13,26560,,,,,,2020-04-22
Valle d'Aosta,92,8,401,501,467,127,1095,2,5024,,,,,,2020-04-22
Sardegna,97,20,716,833,318,96,1247,11,16886,,,,,,2020-04-22
Umbria,97,20,254,371,925,61,1357,4,27655,,,,,,2020-04-22
Bolzano,157,19,1336,1512,648,256,2416,6,32722,,,,,,2020-04-22
Abruzzo,309,35,1764,2108,349,276,2733,66,30348,,,,,,2020-04-22
Friuli VG,134,20,1154,1308,1263,246,2817,25,50869,,,,,,2020-04-22
Sicilia,500,35,1752,2287,388,208,2883,48,58732,,,,,,2020-04-22
Basilicata,65,7,160,232,98,24,354,4,8040,,,,,,2020-04-22
Trento,245,34,1595,1874,1391,381,3646,32,26674,,,,,,2020-04-22
Campania,523,53,2422,2998,860,327,4185,50,55701,,,,,,2020-04-22
Marche,735,76,2419,3230,1849,845,5924,47,46492,,,,,,2020-04-22
Lazio,1384,187,2892,4463,1142,370,5975,80,104062,,,,,,2020-04-22
Liguria,860,92,2524,3476,2420,1022,6918,154,35990,,,,,,2020-04-22
Toscana,820,174,5173,6167,1828,705,8700,97,114100,,,,,,2020-04-22
Veneto,1205,163,8623,9991,5566,1181,16738,334,277543,,,,,,2020-04-22
Piemonte,3213,273,11636,15122,5058,2559,22739,784,111513,,,,,,2020-04-22
Emilia Romagna,2964,282,9838,13084,7146,3204,23434,342,140874,,,,,,2020-04-22
Puglia,564,60,2250,2874,494,362,3730,108,48342,,,,,,2020-04-22
Molise,21,2,182,205,60,19,284,2,4425,,,,,,2020-04-22
Lombardia,9805,851,23322,33978,21374,12579,67931,960,277197,,,,,,2020-04-21
Valle d'Aosta,99,8,415,522,445,126,1093,5,4911,,,,,,2020-04-21
Calabria,133,7,679,819,152,76,1047,9,25440,,,,,,2020-04-21
Sardegna,112,21,704,837,306,93,1236,8,15886,,,,,,2020-04-21
Umbria,107,22,278,407,886,60,1353,4,26639,,,,,,2020-04-21
Bolzano,159,20,1357,1536,623,251,2410,16,31987,,,,,,2020-04-21
Abruzzo,318,35,1714,2067,329,271,2667,55,29906,,,,,,2020-04-21
Sicilia,514,37,1708,2259,370,206,2835,76,55093,,,,,,2020-04-21
Friuli VG,139,21,1162,1322,1229,241,2792,17,48500,,,,,,2020-04-21
Basilicata,64,7,174,245,81,24,350,8,7470,,,,,,2020-04-21
Puglia,569,65,2178,2812,459,351,3622,55,45984,,,,,,2020-04-21
Campania,532,58,2356,2946,872,317,4135,61,53548,,,,,,2020-04-21
Lazio,1380,184,2838,4402,1130,363,5895,80,100031,,,,,,2020-04-21
Marche,784,78,2356,3218,1825,834,5877,51,44332,,,,,,2020-04-21
Liguria,914,94,2455,3463,2311,990,6764,95,34186,,,,,,2020-04-21
Toscana,833,171,5618,6622,1295,686,8603,96,109925,,,,,,2020-04-21
Veneto,1230,177,8670,10077,5173,1154,16404,277,268069,,,,,,2020-04-21
Piemonte,3116,293,11402,14811,4659,2485,21955,606,105434,,,,,,2020-04-21
Emilia Romagna,3045,282,9917,13244,6701,3147,23092,225,134878,,,,,,2020-04-21
Trento,254,38,1617,1909,1329,376,3614,24,26610,,,,,,2020-04-21
Molise,27,2,184,213,51,18,282,1,4124,,,,,,2020-04-21
Lombardia,10138,901,23548,34587,20008,12376,66971,735,270486,,,,,,2020-04-20
Valle d'Aosta,102,8,438,548,413,127,1088,0,4799,,,,,,2020-04-20
Calabria,140,7,681,828,135,75,1038,3,24373,,,,,,2020-04-20
Sardegna,115,21,718,854,288,86,1228,13,15328,,,,,,2020-04-20
Umbria,113,29,282,424,867,58,1349,1,25562,,,,,,2020-04-20
Bolzano,160,19,1361,1540,605,249,2394,14,31381,,,,,,2020-04-20
Abruzzo,320,38,1704,2062,287,263,2612,91,27942,,,,,,2020-04-20
Sicilia,526,39,1645,2210,346,203,2759,42,51373,,,,,,2020-04-20
Friuli VG,140,22,1028,1190,1346,239,2775,30,45161,,,,,,2020-04-20
Basilicata,59,7,176,242,76,24,342,0,6868,,,,,,2020-04-20
Puglia,584,66,2160,2810,431,326,3567,38,44189,,,,,,2020-04-20
Campania,586,61,2372,3019,746,309,4074,45,51090,,,,,,2020-04-20
Lazio,1388,185,2792,4365,1101,349,5815,60,97823,,,,,,2020-04-20
Marche,792,80,2340,3212,1792,822,5826,57,42782,,,,,,2020-04-20
Liguria,878,102,2516,3496,2216,957,6669,141,33007,,,,,,2020-04-20
Toscana,850,182,5536,6568,1272,667,8507,135,105857,,,,,,2020-04-20
Veneto,1273,180,8608,10061,4954,1112,16127,192,260810,,,,,,2020-04-20
Piemonte,3299,301,10957,14557,4383,2409,21349,292,99669,,,,,,2020-04-20
Emilia Romagna,3144,283,10095,13522,6266,3079,22867,307,129530,,,,,,2020-04-20
Trento,272,40,1617,1929,1295,366,3590,58,26211,,,,,,2020-04-20
Molise,27,2,184,213,50,18,281,2,3783,,,,,,2020-04-20
Lombardia,10342,922,23233,34497,19526,12213,66236,855,264155,,,,,,2020-04-19
Valle d'Aosta,102,10,450,562,401,125,1088,15,4677,,,,,,2020-04-19
Calabria,142,6,696,844,116,75,1035,24,23760,,,,,,2020-04-19
Sardegna,117,22,725,864,265,86,1215,17,14859,,,,,,2020-04-19
Umbria,108,30,298,436,854,58,1348,4,25170,,,,,,2020-04-19
Bolzano,162,23,1381,1566,569,245,2380,55,30361,,,,,,2020-04-19
Abruzzo,317,40,1630,1987,276,258,2521,34,27791,,,,,,2020-04-19
Sicilia,522,41,1639,2202,315,200,2717,45,49772,,,,,,2020-04-19
Friuli VG,140,25,1172,1337,1183,225,2745,14,44622,,,,,,2020-04-19
Basilicata,59,8,180,247,71,24,342,3,6528,,,,,,2020-04-19
Puglia,590,60,2136,2786,427,316,3529,120,42598,,,,,,2020-04-19
Campania,590,61,2371,3022,703,304,4029,41,48187,,,,,,2020-04-19
Lazio,1370,185,2766,4321,1093,341,5755,87,91807,,,,,,2020-04-19
Marche,799,86,2297,3182,1780,807,5769,48,41474,,,,,,2020-04-19
Liguria,885,101,2504,3490,2110,928,6528,227,31551,,,,,,2020-04-19
Toscana,852,192,5452,6496,1239,637,8372,135,103975,,,,,,2020-04-19
Veneto,1264,184,8762,10210,4638,1087,15935,243,255797,,,,,,2020-04-19
Piemonte,3201,305,10964,14470,4256,2331,21057,593,96569,,,,,,2020-04-19
Emilia Romagna,3166,289,10097,13552,5985,3023,22560,376,124916,,,,,,2020-04-19
Trento,278,41,1652,1971,1201,360,3532,101,24388,,,,,,2020-04-19
Molise,27,4,184,215,47,17,279,10,3584,,,,,,2020-04-19
Lombardia,10042,947,23206,34195,19136,12050,65381,1246,255331,,,,,,2020-04-18
Valle d'Aosta,107,10,432,549,400,124,1073,80,4521,,,,,,2020-04-18
Calabria,152,7,673,832,106,73,1011,20,22794,,,,,,2020-04-18
Sardegna,112,23,746,881,231,86,1198,20,14087,,,,,,2020-04-18
Umbria,109,32,290,431,856,57,1344,7,24106,,,,,,2020-04-18
Bolzano,179,28,1349,1556,530,239,2325,29,28888,,,,,,2020-04-18
Abruzzo,321,41,1609,1971,263,253,2487,44,27016,,,,,,2020-04-18
Sicilia,526,42,1603,2171,305,196,2672,47,47715,,,,,,2020-04-18
Friuli VG,141,27,1235,1403,1106,222,2731,56,43293,,,,,,2020-04-18
Basilicata,60,8,194,262,54,23,339,2,6056,,,,,,2020-04-18
Puglia,594,60,2040,2694,401,314,3409,82,40423,,,,,,2020-04-18
Campania,605,76,2364,3045,643,300,3988,37,46294,,,,,,2020-04-18
Lazio,1376,186,2720,4282,1046,340,5668,144,89553,,,,,,2020-04-18
Marche,804,88,2280,3172,1754,795,5721,53,39909,,,,,,2020-04-18
Liguria,901,105,2406,3412,1992,897,6301,113,29322,,,,,,2020-04-18
Toscana,883,198,5389,6470,1149,618,8237,127,99903,,,,,,2020-04-18
Veneto,1287,190,8967,10444,4189,1059,15692,318,247329,,,,,,2020-04-18
Piemonte,3271,323,10629,14223,3989,2252,20464,661,91844,,,,,,2020-04-18
Emilia Romagna,3234,296,10054,13584,5635,2965,22184,350,121220,,,,,,2020-04-18
Trento,276,42,1667,1985,1098,348,3431,55,23147,,,,,,2020-04-18
Molise,27,4,178,209,44,16,269,0,3082,,,,,,2020-04-18
Lombardia,10627,971,21836,33434,18850,11851,64135,1041,243513,,,,,,2020-04-17
Valle d'Aosta,108,9,374,491,379,123,993,22,4366,,,,,,2020-04-17
Calabria,154,7,658,819,99,73,991,-18,21657,,,,,,2020-04-17
Sardegna,113,23,736,872,220,86,1178,14,13304,,,,,,2020-04-17
Umbria,111,31,352,494,786,57,1337,8,22818,,,,,,2020-04-17
Bolzano,181,32,1369,1582,480,234,2296,29,27698,,,,,,2020-04-17
Abruzzo,319,43,1580,1942,255,246,2443,97,25436,,,,,,2020-04-17
Sicilia,521,46,1572,2139,296,190,2625,46,45172,,,,,,2020-04-17
Friuli VG,148,23,1257,1428,1027,220,2675,59,40030,,,,,,2020-04-17
Basilicata,59,9,198,266,49,22,337,1,5710,,,,,,2020-04-17
Puglia,590,62,2004,2656,364,307,3327,69,38278,,,,,,2020-04-17
Campania,622,76,2329,3027,631,293,3951,64,43697,,,,,,2020-04-17
Lazio,1332,187,2695,4214,978,332,5524,144,84755,,,,,,2020-04-17
Marche,839,94,2224,3157,1726,785,5668,86,37997,,,,,,2020-04-17
Liguria,897,105,2457,3459,1863,866,6188,149,28181,,,,,,2020-04-17
Toscana,898,207,5478,6583,925,602,8110,167,96231,,,,,,2020-04-17
Veneto,1359,197,9062,10618,3730,1026,15374,384,236722,,,,,,2020-04-17
Piemonte,3266,333,10399,13998,3634,2171,19803,695,86714,,,,,,2020-04-17
Emilia Romagna,3330,309,9946,13585,5346,2903,21834,348,116826,,,,,,2020-04-17
Trento,286,44,1660,1990,1044,342,3376,82,21921,,,,,,2020-04-17
Molise,26,4,178,208,45,16,269,6,3082,,,,,,2020-04-17
Lombardia,11356,1032,20702,33090,18396,11608,63094,941,232674,,,,,,2020-04-16
Valle d'Aosta,105,12,401,518,331,122,971,13,4159,,,,,,2020-04-16
Calabria,157,9,681,847,90,72,1009,38,20642,,,,,,2020-04-16
Sardegna,109,24,732,865,214,85,1164,3,12796,,,,,,2020-04-16
Umbria,116,33,387,536,738,55,1329,7,21487,,,,,,2020-04-16
Bolzano,180,34,1379,1593,449,225,2267,43,26416,,,,,,2020-04-16
Abruzzo,324,42,1484,1850,253,243,2346,72,23786,,,,,,2020-04-16
Sicilia,525,48,1535,2108,284,187,2579,44,42405,,,,,,2020-04-16
Friuli VG,159,26,1145,1330,1069,217,2616,72,35766,,,,,,2020-04-16
Basilicata,60,9,204,273,41,22,336,16,5349,,,,,,2020-04-16
Puglia,603,58,1964,2625,334,299,3258,74,36158,,,,,,2020-04-16
Campania,618,76,2424,3118,483,286,3887,80,41296,,,,,,2020-04-16
Lazio,1347,197,2600,4144,920,316,5380,148,81993,,,,,,2020-04-16
Marche,850,102,2172,3124,1694,764,5582,79,33778,,,,,,2020-04-16
Liguria,957,103,2377,3437,1774,828,6039,103,26945,,,,,,2020-04-16
Toscana,940,213,5460,6613,745,585,7943,277,91651,,,,,,2020-04-16
Veneto,1388,209,9203,10800,3209,981,14990,366,224549,,,,,,2020-04-16
Piemonte,3418,346,10019,13783,3231,2094,19108,879,80708,,,,,,2020-04-16
Emilia Romagna,3360,316,9987,13663,4980,2843,21486,457,112105,,,,,,2020-04-16
Trento,296,43,1748,2087,885,322,3294,74,20773,,,,,,2020-04-16
Molise,25,4,174,203,44,16,263,0,2967,,,,,,2020-04-16
Lombardia,12043,1074,19804,32921,17855,11377,62153,827,221968,,,,,,2020-04-15
Valle d'Aosta,112,11,425,548,289,121,958,11,3894,,,,,,2020-04-15
Calabria,156,11,652,819,81,71,971,15,19662,,,,,,2020-04-15
Sardegna,107,26,737,870,208,83,1161,23,12395,,,,,,2020-04-15
Umbria,122,37,423,582,686,54,1322,1,20258,,,,,,2020-04-15
Bolzano,166,32,1378,1576,425,223,2224,40,25370,,,,,,2020-04-15
Abruzzo,341,44,1425,1810,224,240,2274,29,22500,,,,,,2020-04-15
Sicilia,541,49,1491,2081,273,181,2535,34,39867,,,,,,2020-04-15
Friuli VG,163,24,1207,1394,938,212,2544,24,33800,,,,,,2020-04-15
Basilicata,60,12,189,261,38,21,320,1,5037,,,,,,2020-04-15
Puglia,592,73,1908,2573,323,288,3184,66,34518,,,,,,2020-04-15
Campania,607,86,2394,3087,442,278,3807,38,39534,,,,,,2020-04-15
Lazio,1342,196,2509,4047,874,311,5232,121,75584,,,,,,2020-04-15
Marche,888,106,2103,3097,1660,746,5503,77,30329,,,,,,2020-04-15
Liguria,959,120,2385,3464,1665,807,5936,128,25793,,,,,,2020-04-15
Toscana,977,216,5224,6417,693,556,7666,139,86348,,,,,,2020-04-15
Veneto,1402,219,9168,10789,2895,940,14624,192,216344,,,,,,2020-04-15
Piemonte,3338,366,9491,13195,3019,2015,18229,539,75664,,,,,,2020-04-15
Emilia Romagna,3388,325,9864,13577,4664,2788,21029,277,106149,,,,,,2020-04-15
Trento,312,48,1744,2104,798,318,3220,79,19535,,,,,,2020-04-15
Molise,27,4,175,206,42,15,263,6,2855,,,,,,2020-04-15
Lombardia,12077,1122,19164,32363,17821,11142,61326,1012,214870,,,,,,2020-04-14
Valle d'Aosta,112,14,433,559,270,118,947,20,3726,,,,,,2020-04-14
Calabria,161,12,643,816,72,68,956,28,19014,,,,,,2020-04-14
Sardegna,107,24,769,900,158,80,1138,10,11893,,,,,,2020-04-14
Umbria,127,37,458,622,646,53,1321,1,18956,,,,,,2020-04-14
Bolzano,177,39,1348,1564,406,214,2184,35,24457,,,,,,2020-04-14
Abruzzo,345,52,1403,1800,213,232,2245,32,20935,,,,,,2020-04-14
Sicilia,552,53,1466,2071,255,175,2501,43,37877,,,,,,2020-04-14
Friuli VG,166,28,705,899,1415,206,2520,38,31764,,,,,,2020-04-14
Basilicata,62,12,191,265,35,19,319,0,4759,,,,,,2020-04-14
Puglia,611,62,1879,2552,288,278,3118,53,33071,,,,,,2020-04-14
Campania,618,82,2394,3094,415,260,3769,99,38094,,,,,,2020-04-14
Lazio,1344,199,2479,4022,789,300,5111,143,74650,,,,,,2020-04-14
Marche,937,106,2052,3095,1603,728,5426,45,29160,,,,,,2020-04-14
Liguria,967,133,2366,3466,1549,793,5808,212,24446,,,,,,2020-04-14
Toscana,1002,225,5125,6352,637,538,7527,137,82269,,,,,,2020-04-14
Veneto,1427,233,9076,10736,2790,906,14432,181,208878,,,,,,2020-04-14
Piemonte,3395,367,9293,13055,2708,1927,17690,556,71678,,,,,,2020-04-14
Emilia Romagna,3473,328,9977,13778,4269,2705,20752,312,101896,,,,,,2020-04-14
Trento,325,54,1703,2082,749,310,3141,15,18774,,,,,,2020-04-14
Molise,26,4,170,200,42,15,257,0,2522,,,,,,2020-04-14
Lombardia,12028,1143,18764,31935,17478,10901,60314,1262,211092,,,,,,2020-04-13
Valle d'Aosta,109,15,458,582,230,115,927,6,3614,,,,,,2020-04-13
Calabria,160,12,619,791,70,67,928,5,18596,,,,,,2020-04-13
Sardegna,107,27,780,914,139,75,1128,15,11010,,,,,,2020-04-13
Umbria,127,38,460,625,643,52,1320,1,18740,,,,,,2020-04-13
Bolzano,190,41,1306,1537,400,212,2149,51,24157,,,,,,2020-04-13
Abruzzo,351,54,1373,1778,211,224,2213,53,20667,,,,,,2020-04-13
Sicilia,554,51,1445,2050,237,171,2458,42,37311,,,,,,2020-04-13
Friuli VG,159,30,1118,1307,973,202,2482,51,30941,,,,,,2020-04-13
Basilicata,64,12,194,270,31,18,319,4,4545,,,,,,2020-04-13
Puglia,600,71,1841,2512,286,267,3065,76,31922,,,,,,2020-04-13
Campania,606,80,2376,3062,360,248,3670,66,36770,,,,,,2020-04-13
Lazio,1314,200,2406,3920,764,284,4968,123,72746,,,,,,2020-04-13
Marche,959,108,2013,3080,1588,713,5381,78,28379,,,,,,2020-04-13
Liguria,1088,138,2139,3365,1471,760,5596,102,23129,,,,,,2020-04-13
Toscana,992,225,5040,6257,615,518,7390,155,80889,,,,,,2020-04-13
Veneto,1427,245,9094,10766,2603,882,14251,174,203077,,,,,,2020-04-13
Piemonte,3344,379,9042,12765,2543,1826,17134,474,69170,,,,,,2020-04-13
Emilia Romagna,3490,331,9997,13818,4007,2615,20440,342,99047,,,,,,2020-04-13
Trento,326,56,1698,2080,746,300,3126,73,18586,,,,,,2020-04-13
Molise,28,4,170,202,40,15,257,0,2522,,,,,,2020-04-13
Lombardia,11969,1176,18120,31265,17166,10621,59052,1460,205832,,,,,,2020-04-12
Valle d'Aosta,109,16,463,588,221,112,921,19,3510,,,,,,2020-04-12
Calabria,165,14,616,795,62,66,923,8,18211,,,,,,2020-04-12
Sardegna,109,26,768,903,137,73,1113,22,10663,,,,,,2020-04-12
Umbria,129,39,519,687,580,52,1319,10,18672,,,,,,2020-04-12
Bolzano,183,45,1287,1515,378,205,2098,141,23246,,,,,,2020-04-12
Abruzzo,346,54,1342,1742,206,212,2160,40,20594,,,,,,2020-04-12
Sicilia,552,53,1425,2030,223,163,2416,52,36098,,,,,,2020-04-12
Friuli VG,160,28,1138,1326,910,195,2431,38,29988,,,,,,2020-04-12
Basilicata,61,12,204,277,20,18,315,3,4355,,,,,,2020-04-12
Puglia,609,71,1772,2452,277,260,2989,85,30973,,,,,,2020-04-12
Campania,526,82,2449,3057,305,242,3604,87,35448,,,,,,2020-04-12
Lazio,1268,201,2348,3817,749,279,4845,122,68954,,,,,,2020-04-12
Marche,949,114,2051,3114,1489,700,5303,92,21057,,,,,,2020-04-12
Liguria,1032,144,2157,3333,1412,749,5494,118,21983,,,,,,2020-04-12
Toscana,983,238,4941,6162,578,495,7235,277,78640,,,,,,2020-04-12
Veneto,1428,249,9052,10729,2492,856,14077,309,198442,,,,,,2020-04-12
Piemonte,3429,381,8695,12505,2426,1729,16660,652,66555,,,,,,2020-04-12
Emilia Romagna,3491,335,9846,13672,3862,2564,20098,463,96704,,,,,,2020-04-12
Trento,322,61,1699,2082,678,293,3053,83,17797,,,,,,2020-04-12
Molise,27,4,171,202,40,15,257,11,2471,,,,,,2020-04-12
Lombardia,12026,1174,17058,30258,16823,10511,57592,1544,196302,,,,,,2020-04-11
Valle d'Aosta,118,17,455,590,205,107,902,23,3464,,,,,,2020-04-11
Calabria,169,15,608,792,57,66,915,14,17493,,,,,,2020-04-11
Sardegna,113,24,751,888,130,73,1091,28,10120,,,,,,2020-04-11
Umbria,137,39,547,723,534,52,1309,7,17661,,,,,,2020-04-11
Bolzano,246,56,967,1269,488,200,1957,2,22186,,,,,,2020-04-11
Abruzzo,315,54,1355,1724,190,206,2120,106,19441,,,,,,2020-04-11
Sicilia,562,58,1381,2001,209,154,2364,62,33787,,,,,,2020-04-11
Friuli VG,172,28,1182,1382,826,185,2393,44,29685,,,,,,2020-04-11
Basilicata,60,12,209,281,14,17,312,4,4050,,,,,,2020-04-11
Puglia,627,73,1702,2402,249,253,2904,95,29463,,,,,,2020-04-11
Campania,582,85,2335,3002,277,238,3517,75,33781,,,,,,2020-04-11
Lazio,1264,203,2263,3730,720,273,4723,140,65241,,,,,,2020-04-11
Marche,960,118,2153,3231,1291,689,5211,127,20060,,,,,,2020-04-11
Liguria,1003,146,2184,3333,1309,734,5376,185,20888,,,,,,2020-04-11
Toscana,997,237,4758,5992,499,467,6958,231,75756,,,,,,2020-04-11
Veneto,1465,251,9033,10749,2188,831,13768,347,190912,,,,,,2020-04-11
Piemonte,3435,384,8351,12170,2205,1633,16008,996,62577,,,,,,2020-04-11
Emilia Romagna,3530,341,9624,13495,3659,2481,19635,507,91759,,,,,,2020-04-11
Trento,335,62,1667,2064,622,284,2970,154,16646,,,,,,2020-04-11
Molise,28,4,161,193,39,14,246,3,2201,,,,,,2020-04-11
Lombardia,11877,1202,16451,29530,16280,10238,56048,1246,186325,,,,,,2020-04-10
Valle d'Aosta,131,16,455,602,170,107,879,11,3328,,,,,,2020-04-10
Calabria,168,14,604,786,50,65,901,27,16637,,,,,,2020-04-10
Sardegna,107,26,743,876,118,69,1063,37,9444,,,,,,2020-04-10
Umbria,146,39,567,752,498,52,1302,4,16325,,,,,,2020-04-10
Bolzano,258,58,1001,1317,447,191,1955,52,20866,,,,,,2020-04-10
Abruzzo,305,53,1277,1635,181,198,2014,83,18088,,,,,,2020-04-10
Sicilia,568,62,1337,1967,187,148,2302,70,31156,,,,,,2020-04-10
Friuli VG,167,33,1198,1398,772,179,2349,50,28097,,,,,,2020-04-10
Basilicata,59,15,205,279,14,15,308,5,3696,,,,,,2020-04-10
Puglia,631,80,1625,2336,235,238,2809,93,27812,,,,,,2020-04-10
Campania,600,90,2273,2963,248,231,3442,98,31745,,,,,,2020-04-10
Lazio,1236,201,2196,3633,687,263,4583,154,61769,,,,,,2020-04-10
Marche,925,127,2264,3316,1086,682,5084,129,18970,,,,,,2020-04-10
Liguria,1076,151,2074,3301,1181,709,5191,171,19514,,,,,,2020-04-10
Toscana,1011,256,4555,5822,451,454,6727,175,72001,,,,,,2020-04-10
Veneto,1521,257,8869,10647,1981,793,13421,488,180700,,,,,,2020-04-10
Piemonte,3497,394,7685,11576,1904,1532,15012,490,57457,,,,,,2020-04-10
Emilia Romagna,3596,349,9405,13350,3381,2397,19128,451,85884,,,,,,2020-04-10
Trento,335,70,1589,1994,547,275,2816,108,14981,,,,,,2020-04-10
Molise,28,4,161,193,37,13,243,9,2069,,,,,,2020-04-10
Lombardia,11796,1236,16042,29074,15706,10022,54802,1388,176953,,,,,,2020-04-09
Valle d'Aosta,118,18,473,609,154,105,868,18,3142,,,,,,2020-04-09
Calabria,168,15,582,765,48,61,874,15,15698,,,,,,2020-04-09
Sardegna,106,25,745,876,86,64,1026,51,8918,,,,,,2020-04-09
Umbria,154,38,600,792,455,51,1298,9,15170,,,,,,2020-04-09
Bolzano,263,64,988,1315,401,187,1903,68,19875,,,,,,2020-04-09
Abruzzo,306,57,1203,1566,171,194,1931,72,16847,,,,,,2020-04-09
Sicilia,566,63,1313,1942,152,138,2232,73,28742,,,,,,2020-04-09
Friuli VG,167,37,1186,1390,738,171,2299,81,26205,,,,,,2020-04-09
Basilicata,50,17,208,275,13,15,303,6,3474,,,,,,2020-04-09
Puglia,630,86,1585,2301,190,225,2716,82,26088,,,,,,2020-04-09
Campania,604,94,2175,2873,244,227,3344,76,29664,,,,,,2020-04-09
Lazio,1244,198,2090,3532,644,253,4429,163,58107,,,,,,2020-04-09
Marche,945,133,2323,3401,885,669,4955,96,18194,,,,,,2020-04-09
Liguria,1103,154,1996,3253,1085,682,5020,114,18446,,,,,,2020-04-09
Toscana,1038,256,4409,5703,441,408,6552,173,65461,,,,,,2020-04-09
Veneto,1530,274,8645,10449,1728,756,12933,523,171456,,,,,,2020-04-09
Piemonte,3514,412,7410,11336,1732,1454,14522,639,52807,,,,,,2020-04-09
Emilia Romagna,3722,355,9181,13258,3103,2316,18677,443,81715,,,,,,2020-04-09
Trento,345,69,1564,1978,462,268,2708,106,14338,,,,,,2020-04-09
Molise,30,4,155,189,32,13,234,8,2069,,,,,,2020-04-09
Lombardia,11719,1257,15569,28545,15147,9722,53414,1089,167557,,,,,,2020-04-08
Valle d'Aosta,120,20,466,606,142,102,850,15,2953,,,,,,2020-04-08
Calabria,170,15,570,755,44,60,859,26,14977,,,,,,2020-04-08
Sardegna,112,31,697,840,76,59,975,40,8493,,,,,,2020-04-08
Umbria,155,41,627,823,416,50,1289,26,14105,,,,,,2020-04-08
Bolzano,268,65,948,1281,371,183,1835,24,18865,,,,,,2020-04-08
Abruzzo,331,62,1141,1534,146,179,1859,60,15846,,,,,,2020-04-08
Sicilia,563,65,1265,1893,133,133,2159,62,27438,,,,,,2020-04-08
Friuli VG,162,41,1212,1415,634,169,2218,65,24798,,,,,,2020-04-08
Basilicata,48,17,205,270,13,14,297,6,3296,,,,,,2020-04-08
Puglia,639,90,1509,2238,177,219,2634,120,24493,,,,,,2020-04-08
Trento,354,77,1509,1940,407,255,2602,126,13258,,,,,,2020-04-08
Lazio,1241,196,2011,3448,574,244,4266,117,55113,,,,,,2020-04-08
Liguria,1109,153,1983,3245,1007,654,4906,149,17521,,,,,,2020-04-08
Marche,974,133,2455,3562,645,652,4859,149,17532,,,,,,2020-04-08
Toscana,1066,260,4231,5557,430,392,6379,206,60985,,,,,,2020-04-08
Veneto,1554,285,8332,10171,1503,736,12410,485,163247,,,,,,2020-04-08
Piemonte,3493,423,7073,10989,1516,1378,13883,540,48495,,,,,,2020-04-08
Emilia Romagna,3769,361,8980,13110,2890,2234,18234,409,78367,,,,,,2020-04-08
Campania,608,97,2154,2859,188,221,3268,120,27784,,,,,,2020-04-08
Molise,30,4,147,181,32,13,226,2,2002,,,,,,2020-04-08
Lombardia,11833,1305,15205,28343,14498,9484,52325,159331,,,,,,,2020-04-07
Valle d'Aosta,118,17,458,593,142,100,835,2754,,,,,,,2020-04-07
Calabria,169,14,550,733,40,60,833,14072,,,,,,,2020-04-07
Sardegna,122,26,673,821,62,52,935,7680,,,,,,,2020-04-07
Umbria,157,41,648,846,368,49,1263,13274,,,,,,,2020-04-07
Bolzano,325,64,912,1301,336,174,1811,17761,,,,,,,2020-04-07
Abruzzo,337,67,1087,1491,136,172,1799,14904,,,,,,,2020-04-07
Sicilia,562,73,1224,1859,113,125,2097,24857,,,,,,,2020-04-07
Friuli VG,185,44,1150,1379,610,164,2153,23536,,,,,,,2020-04-07
Basilicata,47,17,201,265,12,14,291,3160,,,,,,,2020-04-07
Puglia,615,93,1429,2137,168,209,2514,23149,,,,,,,2020-04-07
Campania,603,103,2059,2765,167,216,3148,25779,,,,,,,2020-04-07
Lazio,1229,192,1944,3365,546,238,4149,48874,,,,,,,2020-04-07
Liguria,1090,156,1966,3212,925,620,4757,16579,,,,,,,2020-04-07
Marche,962,139,2637,3738,342,630,4710,16619,,,,,,,2020-04-07
Toscana,1087,263,4077,5427,377,369,6173,56651,,,,,,,2020-04-07
Veneto,1579,297,8089,9965,1265,695,11925,153542,,,,,,,2020-04-07
Piemonte,3553,432,6719,10704,1320,1319,13343,44121,,,,,,,2020-04-07
Emilia Romagna,3750,366,8932,13048,2597,2180,17825,75191,,,,,,,2020-04-07
Trento,360,78,1452,1890,342,244,2476,12030,,,,,,,2020-04-07
Molise,35,5,145,185,26,13,224,1581,,,,,,,2020-04-07
Lombardia,11914,1343,15212,28469,13863,9202,51534,154989,,,,,,,2020-04-06
Valle d'Aosta,109,21,437,567,142,96,805,2590,,,,,,,2020-04-06
Calabria,170,14,538,722,37,58,817,13633,,,,,,,2020-04-06
Sardegna,123,26,670,819,56,47,922,7521,,,,,,,2020-04-06
Umbria,159,46,667,872,337,44,1253,12573,,,,,,,2020-04-06
Bolzano,245,52,963,1260,298,164,1722,16825,,,,,,,2020-04-06
Abruzzo,340,66,1019,1425,127,169,1721,14198,,,,,,,2020-04-06
Sicilia,563,74,1178,1815,108,123,2046,23464,,,,,,,2020-04-06
Friuli VG,189,46,1161,1396,549,158,2103,22272,,,,,,,2020-04-06
Basilicata,46,18,198,262,12,13,287,3061,,,,,,,2020-04-06
Puglia,625,97,1393,2115,134,195,2444,22059,,,,,,,2020-04-06
Campania,610,101,1987,2698,156,204,3058,24526,,,,,,,2020-04-06
Lazio,1235,197,1868,3300,502,229,4031,47470,,,,,,,2020-04-06
Liguria,1141,162,1814,3117,837,595,4549,15533,,,,,,,2020-04-06
Marche,1001,140,2565,3706,296,612,4614,15919,,,,,,,2020-04-06
Toscana,1116,279,3906,5301,350,350,6001,52849,,,,,,,2020-04-06
Veneto,1714,322,7686,9722,1204,662,11588,146288,,,,,,,2020-04-06
Piemonte,3484,438,6623,10545,1128,1251,12924,41123,,,,,,,2020-04-06
Emilia Romagna,3804,372,8875,13051,2397,2108,17556,72163,,,,,,,2020-04-06
Trento,354,79,1405,1838,280,230,2348,11130,,,,,,,2020-04-06
Molise,34,5,148,187,24,13,224,1546,,,,,,,2020-04-06
Lombardia,12009,1317,14798,28124,13426,8905,50455,149984,,,,,,,2020-04-05
Valle d'Aosta,96,23,457,576,115,91,782,2390,,,,,,,2020-04-05
Calabria,174,13,519,706,33,56,795,13077,,,,,,,2020-04-05
Sardegna,126,25,664,815,49,43,907,7157,,,,,,,2020-04-05
Umbria,159,45,694,898,298,43,1239,12448,,,,,,,2020-04-05
Bolzano,239,53,934,1226,260,158,1644,15723,,,,,,,2020-04-05
Abruzzo,347,67,1006,1420,125,158,1703,13598,,,,,,,2020-04-05
Sicilia,556,76,1142,1774,104,116,1994,21904,,,,,,,2020-04-05
Friuli VG,185,50,1128,1363,531,154,2048,21652,,,,,,,2020-04-05
Basilicata,46,18,190,254,11,13,278,2931,,,,,,,2020-04-05
Puglia,574,159,1289,2022,113,182,2317,20080,,,,,,,2020-04-05
Campania,609,108,1904,2621,150,189,2960,23139,,,,,,,2020-04-05
Lazio,1235,197,1754,3186,475,219,3880,44658,,,,,,,2020-04-05
Liguria,1126,165,1802,3093,800,556,4449,15047,,,,,,,2020-04-05
Marche,987,151,2440,3578,287,599,4464,15252,,,,,,,2020-04-05
Toscana,1111,276,3798,5185,337,325,5847,51006,,,,,,,2020-04-05
Veneto,1674,329,7406,9409,1186,631,11226,140910,,,,,,,2020-04-05
Piemonte,3472,444,6261,10177,1017,1168,12362,38539,,,,,,,2020-04-05
Emilia Romagna,3839,375,8623,12837,2201,2051,17089,69986,,,,,,,2020-04-05
Trento,352,80,1363,1795,273,217,2285,10476,,,,,,,2020-04-05
Molise,33,6,148,187,24,13,224,1504,,,,,,,2020-04-05
Lombardia,12002,1326,13892,27220,13242,8656,49118,141877,,,,,,,2020-04-04
Valle d'Aosta,63,23,474,560,106,82,748,2274,,,,,,,2020-04-04
Calabria,178,15,469,662,30,49,741,12314,,,,,,,2020-04-04
Sardegna,123,24,642,789,44,41,874,6789,,,,,,,2020-04-04
Umbria,167,44,716,927,242,41,1210,11809,,,,,,,2020-04-04
Bolzano,291,61,849,1201,245,146,1592,15045,,,,,,,2020-04-04
Abruzzo,354,71,931,1356,119,153,1628,12837,,,,,,,2020-04-04
Sicilia,553,74,1099,1726,95,111,1932,19896,,,,,,,2020-04-04
Friuli VG,183,50,1103,1336,505,145,1986,21126,,,,,,,2020-04-04
Basilicata,44,19,181,244,9,11,264,2765,,,,,,,2020-04-04
Puglia,627,153,1193,1973,94,173,2240,18977,,,,,,,2020-04-04
Campania,567,114,1815,2496,146,186,2828,21534,,,,,,,2020-04-04
Lazio,1236,193,1677,3106,439,212,3757,44624,,,,,,,2020-04-04
Liguria,1121,169,1604,2894,767,542,4203,14087,,,,,,,2020-04-04
Marche,997,153,2347,3497,270,574,4341,14472,,,,,,,2020-04-04
Toscana,1129,286,3639,5054,310,307,5671,47886,,,,,,,2020-04-04
Veneto,1691,324,7078,9093,1124,607,10824,133289,,,,,,,2020-04-04
Piemonte,3441,450,5802,9693,888,1128,11709,37181,,,,,,,2020-04-04
Emilia Romagna,3859,358,8306,12523,2040,1977,16540,67075,,,,,,,2020-04-04
Trento,353,81,1319,1753,257,210,2220,9863,,,,,,,2020-04-04
Molise,31,6,134,171,24,11,206,1504,,,,,,,2020-04-04
Lombardia,11802,1381,13006,26189,13020,8311,47520,135051,,,,,,,2020-04-03
Valle d'Aosta,85,25,450,560,89,70,719,2106,,,,,,,2020-04-03
Calabria,183,17,462,662,26,45,733,11608,,,,,,,2020-04-03
Sardegna,122,24,598,744,40,41,825,6478,,,,,,,2020-04-03
Umbria,165,48,707,920,220,39,1179,10614,,,,,,,2020-04-03
Bolzano,291,60,858,1209,211,139,1559,13976,,,,,,,2020-04-03
Abruzzo,361,76,864,1301,116,146,1563,11890,,,,,,,2020-04-03
Sicilia,535,73,1056,1664,94,101,1859,18686,,,,,,,2020-04-03
Friuli VG,201,61,1062,1324,419,136,1879,19985,,,,,,,2020-04-03
Basilicata,41,19,187,247,3 11,261,2622,,,,,,,,2020-04-03
Puglia,648,123,1178,1949,69,164,2182,17924,,,,,,,2020-04-03
Campania,532,115,1705,2352,144,181,2677,19237,,,,,,,2020-04-03
Lazio,1194,188,1627,3009,392,199,3600,43776,,,,,,,2020-04-03
Liguria,1147,173,1426,2746,700,519,3965,12934,,,,,,,2020-04-03
Marche,982,158,2491,3631,42,557,4230,13678,,,,,,,2020-04-03
Toscana,1149,288,3472,4909,300,290,5499,44460,,,,,,,2020-04-03
Veneto,1714,335,6812,8861,1031,572,10464,126490,,,,,,,2020-04-03
Piemonte,3300,452,5378,9130,723,1043,10896,34281,,,,,,,2020-04-03
Emilia Romagna,3915,364,7899,12178,1852,1902,15932,63682,,,,,,,2020-04-03
Trento,343,80,1236,1659,246,204,2109,8993,,,,,,,2020-04-03
Molise,31,8,105,144,21,11,176,1378,,,,,,,2020-04-03
Lombardia,11762,1351,12763,25876,12229,7960,46065,128286,,,,,,,2020-04-02
Valle d'Aosta,85,25,446,556,49,63,668,1934,,,,,,,2020-04-02
Calabria,163,19,445,627,23,41,691,10679,,,,,,,2020-04-02
Sardegna,117,24,577,718,36,40,794,5970,,,,,,,2020-04-02
Umbria,171,47,667,885,205,38,1128,9737,,,,,,,2020-04-02
Bolzano,279,60,821,1160,190,129,1479,12677,,,,,,,2020-04-02
Abruzzo,341,75,835,1251,113,133,1497,10647,,,,,,,2020-04-02
Sicilia,503,73,1030,1606,92,93,1791,17833,,,,,,,2020-04-02
Friuli VG,199,60,1035,1294,376,129,1799,17121,,,,,,,2020-04-02
Basilicata,38,19,176,233,3,10,246,2427,,,,,,,2020-04-02
Puglia,645,118,1101,1864,69,144,2077,16554,,,,,,,2020-04-02
Campania,503,120,1517,2140,149,167,2456,17404,,,,,,,2020-04-02
Lazio,1169,181,1529,2879,369,185,3433,41575,,,,,,,2020-04-02
Liguria,1120,172,1368,2660,634,488,3782,12069,,,,,,,2020-04-02
Marche,986,164,2405,3555,40,503,4098,12943,,,,,,,2020-04-02
Toscana,1135,295,3359,4789,216,268,5273,40724,,,,,,,2020-04-02
Piemonte,3341,453,5005,8799,571,983,10353,32100,,,,,,,2020-04-02
Veneto,1670,345,6563,8578,1001,532,10111,120320,,,,,,,2020-04-02
Emilia Romagna,3944,366,7549,11859,1663,1811,15333,60507,,,,,,,2020-04-02
Trento,339,78,1170,1587,229,187,2003,8496,,,,,,,2020-04-02
Molise,30,8,95,133,21,11,165,1229,,,,,,,2020-04-02
Lombardia,11927,1342,12496,25765,11415,7593,44773,121449,,,,,,,2020-04-01
Valle d'Aosta,85,27,428,540,32,59,631,1717,,,,,,,2020-04-01
Calabria,144,16,450,610,21,38,669,9983,,,,,,,2020-04-01
Sardegna,119,27,529,675,36,34,745,5501,,,,,,,2020-04-01
Umbria,173,45,646,864,194,37,1095,9080,,,,,,,2020-04-01
Bolzano,269,57,786,1112,190,116,1418,11951,,,,,,,2020-04-01
Abruzzo,342,71,798,1211,102,123,1436,9610,,,,,,,2020-04-01
Sicilia,496,72,976,1544,86,88,1718,16836,,,,,,,2020-04-01
Friuli VG,206,60,940,1206,357,122,1685,15987,,,,,,,2020-04-01
Basilicata,39,15,171,225,3,9,237,2262,,,,,,,2020-04-01
Puglia,637,107,1012,1756,61,129,1946,15209,,,,,,,2020-04-01
Campania,478,129,1369,1976,107,148,2231,15728,,,,,,,2020-04-01
Lazio,1131,177,1450,2758,337,169,3264,35810,,,,,,,2020-04-01
Liguria,1114,179,1352,2645,555,460,3660,11334,,,,,,,2020-04-01
Marche,984,168,2304,3456,29,477,3962,12296,,,,,,,2020-04-01
Toscana,1120,297,3015,4432,182,253,4867,36575,,,,,,,2020-04-01
Piemonte,3146,453,4871,8470,439,886,9795,30060,,,,,,,2020-04-01
Veneto,1718,350,6156,8224,902,499,9625,112746,,,,,,,2020-04-01
Emilia Romagna,3898,359,7232,11489,1566,1732,14787,58457,,,,,,,2020-04-01
Trento,345,76,1062,1483,214,173,1870,7675,,,,,,,2020-04-01
Molise,32,8,91,131,19,10,160,1157,,,,,,,2020-04-01
Lombardia,11883,1324,11917,25124,10885,7199,43208,114640,,,,,,,2020-03-31
Valle d'Aosta,91,26,435,552,20,56,628,1582,,,,,,,2020-03-31
Calabria,132,17,457,606,17,36,659,9327,,,,,,,2020-03-31
Sardegna,113,28,516,657,34,31,722,5257,,,,,,,2020-03-31
Umbria,176,43,632,851,190,37,1078,8685,,,,,,,2020-03-31
Bolzano,249,62,831,1142,153,76,1371,11275,,,,,,,2020-03-31
Abruzzo,335,73,783,1191,95,115,1401,8758,,,,,,,2020-03-31
Sicilia,503,72,917,1492,74,81,1647,15634,,,,,,,2020-03-31
Friuli VG,215,60,885,1160,320,113,1593,14899,,,,,,,2020-03-31
Basilicata,37,17,162,216,3,7,226,2043,,,,,,,2020-03-31
Puglia,609,105,940,1654,39,110,1803,14073,,,,,,,2020-03-31
Campania,501,133,1237,1871,88,133,2092,14403,,,,,,,2020-03-31
Lazio,1127,173,1342,2642,291,162,3095,34677,,,,,,,2020-03-31
Liguria,1153,179,1176,2508,480,428,3416,10376,,,,,,,2020-03-31
Marche,946,169,2237,3352,21,452,3825,11724,,,,,,,2020-03-31
Toscana,1120,293,2813,4226,138,244,4608,33165,,,,,,,2020-03-31
Piemonte,3174,452,4456,8082,365,854,9301,27658,,,,,,,2020-03-31
Veneto,1680,356,5814,7850,828,477,9155,106238,,,,,,,2020-03-31
Emilia Romagna,3765,353,6835,10953,1477,1644,14074,54532,,,,,,,2020-03-31
Trento,354,80,955,1389,193,164,1746,6973,,,,,,,2020-03-31
Molise,29,8,80,117,18,9,144,1049,,,,,,,2020-03-31
Lombardia,11815,1330,11861,25006,10337,6818,42161,111057,,,,,,,2020-03-30
Valle d'Aosta,92,26,400,518,16,50,584,1536,,,,,,,2020-03-30
Calabria,130,18,454,602,14,31,647,9013,,,,,,,2020-03-30
Sardegna,113,24,485,622,32,28,682,4993,,,,,,,2020-03-30
Umbria,173,47,614,834,184,33,1051,8150,,,,,,,2020-03-30
Bolzano,231,62,805,1098,153,74,1325,10640,,,,,,,2020-03-30
Abruzzo,322,69,778,1169,74,102,1345,7948,,,,,,,2020-03-30
Sicilia,484,75,849,1408,71,76,1555,14758,,,,,,,2020-03-30
Friuli VG,229,60,820,1109,285,107,1501,14003,,,,,,,2020-03-30
Basilicata,36,18,154,208,1,5,214,1833,,,,,,,2020-03-30
Puglia,590,106,889,1585,36,91,1712,13117,,,,,,,2020-03-30
Campania,468,126,1145,1739,88,125,1952,12969,,,,,,,2020-03-30
Lazio,1079,154,1264,2497,267,150,2914,32846,,,,,,,2020-03-30
Liguria,1142,175,1066,2383,437,397,3217,9677,,,,,,,2020-03-30
Marche,998,167,2086,3251,16,417,3684,10979,,,,,,,2020-03-30
Toscana,1116,279,2655,4050,131,231,4412,30099,,,,,,,2020-03-30
Piemonte,2985,452,4218,7655,308,749,8712,25478,,,,,,,2020-03-30
Veneto,1633,356,5575,7564,747,413,8724,99941,,,,,,,2020-03-30
Emilia Romagna,3779,351,6636,10766,1227,1538,13531,50990,,,,,,,2020-03-30
Trento,353,78,926,1357,178,147,1682,6377,,,,,,,2020-03-30
Molise,27,8,72,107,18,9,134,955,,,,,,,2020-03-30
Lombardia,11613,1328,12451,25392,9255,6360,41007,107398,,,,,,,2020-03-29
Valle d'Aosta,90,26,423,539,2,43,584,1480,,,,,,,2020-03-29
Calabria,124,19,434,577,12,25,614,8485,,,,,,,2020-03-29
Sardegna,105,23,454,582,29,27,638,4598,,,,,,,2020-03-29
Umbria,166,46,685,897,95,31,1023,7685,,,,,,,2020-03-29
Bolzano,234,56,744,1034,116,64,1214,10137,,,,,,,2020-03-29
Abruzzo,329,68,772,1169,36,88,1293,7730,,,,,,,2020-03-29
Sicilia,451,71,808,1330,65,65,1460,13814,,,,,,,2020-03-29
Friuli VG,236,60,845,1141,241,98,1480,13397,,,,,,,2020-03-29
Basilicata,32,18,147,197,1,4,202,1585,,,,,,,2020-03-29
Puglia,559,99,774,1432,31,86,1549,12361,,,,,,,2020-03-29
Campania,476,135,945,1556,86,117,1759,11805,,,,,,,2020-03-29
Lazio,1062,133,1167,2362,208,136,2706,27744,,,,,,,2020-03-29
Liguria,1077,166,1036,2279,420,377,3076,9100,,,,,,,2020-03-29
Marche,1000,168,1992,3160,12,386,3558,10431,,,,,,,2020-03-29
Toscana,1111,275,2400,3786,121,215,4122,27579,,,,,,,2020-03-29
Piemonte,2985,443,3840,7268,254,684,8206,24058,,,,,,,2020-03-29
Veneto,1586,355,5310,7251,715,392,8358,94784,,,,,,,2020-03-29
Emilia Romagna,3769,333,6433,10535,1141,1443,13119,52991,,,,,,,2020-03-29
Trento,356,75,862,1293,172,129,1594,5950,,,,,,,2020-03-29
Molise,25,9,66,100,18,9,127,918,,,,,,,2020-03-29
Lombardia,11152,1319,12038,24509,8962,5944,39415,102503,,,,,,,2020-03-28
Calabria,107,22,394,523,11,21,555,7760,,,,,,,2020-03-28
Sardegna,95,22,452,569,29,26,624,4225,,,,,,,2020-03-28
Valle d'Aosta,90,26,352,468,2,41,511,1380,,,,,,,2020-03-28
Umbria,159,44,695,898,43,28,969,7028,,,,,,,2020-03-28
Bolzano,225,51,653,929,116,64,1109,9168,,,,,,,2020-03-28
Abruzzo,311,70,646,1027,30,76,1133,7003,,,,,,,2020-03-28
Sicilia,441,71,730,1242,60,57,1359,13096,,,,,,,2020-03-28
Friuli VG,223,59,838,1120,229,87,1436,12723,,,,,,,2020-03-28
Puglia,563,98,697,1358,29,71,1458,11500,,,,,,,2020-03-28
Trento,351,72,811,1234,151,120,1505,5561,,,,,,,2020-03-28
Campania,463,132,812,1407,76,109,1592,10616,,,,,,,2020-03-28
Lazio,985,133,1063,2181,200,124,2505,27179,,,,,,,2020-03-28
Liguria,1031,167,888,2086,378,358,2822,8177,,,,,,,2020-03-28
Toscana,1093,277,2141,3511,108,198,3817,25613,,,,,,,2020-03-28
Marche,987,166,1846,2999,10,364,3373,9884,,,,,,,2020-03-28
Piemonte,3094,439,3318,6851,203,617,7671,21511,,,,,,,2020-03-28
Veneto,1559,344,5010,6913,655,362,7930,89380,,,,,,,2020-03-28
Emilia Romagna,3695,316,5953,9964,1075,1344,12383,52991,,,,,,,2020-03-28
Basilicata,26,19,133,178,1,3,182,1421,,,,,,,2020-03-28
Molise,26,9,63,98,16,9,123,807,,,,,,,2020-03-28
Lombardia,11137,1292,11466,23895,8001,5402,37298,95860,,,,,,,2020-03-27
Calabria,103,22,344,469,7 18,494,6901,,,,,,,,2020-03-27
Sardegna,93,19,384,496,13,21,530,3801,,,,,,,2020-03-27
Valle d'Aosta,91,24,298,413,2 37,452,1252,,,,,,,,2020-03-27
Umbria,149,46,629,824,39,21,884,6137,,,,,,,2020-03-27
Bolzano,249,45,539,833,110,60,1003,8520,,,,,,,2020-03-27
Abruzzo,289,71,565,925,24,68,1017,6109,,,,,,,2020-03-27
Sicilia,425,75,658,1158,53,39,1250,11079,,,,,,,2020-03-27
Friuli VG,222,57,748,1027,214,76,1317,11841,,,,,,,2020-03-27
Basilicata,22,15,110,147,1 3,151,1254,,,,,,,,2020-03-27
Puglia,530,82,624,1236,29,69,1334,10233,,,,,,,2020-03-27
Campania,456,113,723,1292,64,98,1454,9613,,,,,,,2020-03-27
Lazio,992,126,895,2013,164,118,2295,24106,,,,,,,2020-03-27
Liguria,1023,157,880,2060,305,331,2696,7804,,,,,,,2020-03-27
Toscana,1053,274,1843,3170,103,177,3450,23746,,,,,,,2020-03-27
Marche,979,162,1709,2850,10,336,3196,9060,,,,,,,2020-03-27
Piemonte,2852,431,3064,6347,176,569,7092,19705,,,,,,,2020-03-27
Veneto,1536,338,4774,6648,536,313,7497,83627,,,,,,,2020-03-27
Emilia Romagna,3461,308,5592,9361,960,1267,11588,47798,,,,,,,2020-03-27
Trento,341,66,757,1164,125,102,1391,4923,,,,,,,2020-03-27
Molise,26,9,51,86,14,9,109,,,,,,,,2020-03-27
Lombardia,10681,1263,10245,22189,7839,4861,34889,87713,,,,,,,2020-03-26
Calabria,101,23,248,372,7 14,393,5933,,,,,,,,2020-03-26
Sardegna,92,20,350,462,13,19,494,3461,,,,,,,2020-03-26
Valle d'Aosta,73,24,281,378,2 28,408,1203,,,,,,,,2020-03-26
Umbria,144,46,580,770,12,20,802,5428,,,,,,,2020-03-26
Bolzano,223,43,525,791,67,48,906,7744,,,,,,,2020-03-26
Abruzzo,280,64,516,860,23,63,946,5488,,,,,,,2020-03-26
Sicilia,346,68,681,1095,36,33,1164,9658,,,,,,,2020-03-26
Friuli VG,212,54,688,954,197,72,1223,10721,,,,,,,2020-03-26
Basilicata,22,16,95,133,1 134,1046,,,,,,,,,2020-03-26
Puglia,480,76,539,1095,22,65,1182,9191,,,,,,,2020-03-26
Campania,448,114,607,1169,58,83,1310,8346,,,,,,,2020-03-26
Lazio,878,113,844,1835,155,106,2096,22771,,,,,,,2020-03-26
Liguria,998,154,875,2027,260,280,2567,7304,,,,,,,2020-03-26
Toscana,1037,259,1677,2973,95,158,3226,20952,,,,,,,2020-03-26
Marche,977,166,1652,2795,9 310,3114,8623,,,,,,,,2020-03-26
Piemonte,2633,408,2909,5950,135,449,6534,18054,,,,,,,2020-03-26
Veneto,1447,326,4367,6140,508,287,6935,79759,,,,,,,2020-03-26
Emilia Romagna,3354,301,5195,8850,792,1174,10816,42395,,,,,,,2020-03-26
Trento,300,66,728,1094,117,86,1297,4600,,,,,,,2020-03-26
Molise,27,8,46,81,14,8,103,670,,,,,,,2020-03-26
Lombardia,10026,1236,9329,20591,7281,4474,32346,81666,,,,,,,2020-03-25
Calabria,93,23,217,333,7,11,351,5058,,,,,,,2020-03-25
Sardegna,82,19,311,412,12,18,442,3019,,,,,,,2020-03-25
Valle d'Aosta,70,25,280,375,2,24,401,1200,,,,,,,2020-03-25
Umbria,123,44,519,686,5,19,710,4707,,,,,,,2020-03-25
Abruzzo,248,59,431,738,23,52,813,4982,,,,,,,2020-03-25
Sicilia,259,80,597,936,33,25,994,8312,,,,,,,2020-03-25
Bolzano,190,40,518,748,67,43,858,6649,,,,,,,2020-03-25
Friuli VG,200,52,659,911,158,70,1139,9494,,,,,,,2020-03-25
Basilicata,20,14,78,112,,1,113,857,,,,,,,2020-03-25
Puglia,349,64,610,1023,22,48,1093,8223,,,,,,,2020-03-25
Campania,318,123,631,1072,53,74,1199,6972,,,,,,,2020-03-25
Lazio,805,101,769,1675,131,95,1901,20669,,,,,,,2020-03-25
Liguria,927,147,752,1826,225,254,2305,6602,,,,,,,2020-03-25
Toscana,999,251,1526,2776,54,142,2972,17868,,,,,,,2020-03-25
Marche,938,148,1553,2639,8,287,2934,7896,,,,,,,2020-03-25
Piemonte,2544,381,2631,5556,19,449,6024,16655,,,,,,,2020-03-25
Veneto,1407,316,4022,5745,439,258,6442,70877,,,,,,,2020-03-25
Emilia Romagna,3180,294,4782,8256,721,1077,10054,38045,,,,,,,2020-03-25
Trento,308,65,685,1058,90,74,1222,4114,,,,,,,2020-03-25
Molise,26,7,20,53,12,8,73,580,,,,,,,2020-03-25
Lombardia,9711,1194,8963,19868,6657,4178,30703,76695,,,,,,,2020-03-24
Calabria,88,21,195,304,5,10,319,4486,,,,,,,2020-03-24
Sardegna,80,19,296,395,11,15,421,2859,,,,,,,2020-03-24
Valle d'Aosta,71,20,288,379,2,19,400,1180,,,,,,,2020-03-24
Umbria,105,43,476,624,5,19,648,4108,,,,,,,2020-03-24
Abruzzo,234,57,331,622,21,46,689,4294,,,,,,,2020-03-24
Sicilia,250,60,489,799,27,20,846,7170,,,,,,,2020-03-24
Bolzano,166,38,495,699,44,38,781,6509,,,,,,,2020-03-24
Friuli VG,195,49,604,848,80,64,992,8526,,,,,,,2020-03-24
Basilicata,14,12,65,91,,1,92,744,,,,,,,2020-03-24
Puglia,317,57,566,940,21,44,1005,7345,,,,,,,2020-03-24
Campania,345,181,466,992,53,56,1101,6297,,,,,,,2020-03-24
Lazio,747,94,704,1545,103,80,1728,18371,,,,,,,2020-03-24
Liguria,803,147,742,1692,193,231,2116,5992,,,,,,,2020-03-24
Toscana,918,244,1357,2519,51,129,2699,15701,,,,,,,2020-03-24
Marche,862,149,1486,2497,8,231,2736,7229,,,,,,,2020-03-24
Piemonte,2404,360,2360,5124,17,374,5515,15469,,,,,,,2020-03-24
Veneto,1318,304,3729,5351,381,216,5948,66178,,,,,,,2020-03-24
Emilia Romagna,2974,291,4446,7711,558,985,9254,33527,,,,,,,2020-03-24
Trento,308,49,618,975,79,56,1110,3712,,,,,,,2020-03-24
Molise,27,7,21,55,10,8,73,572,,,,,,,2020-03-24
Lombardia,9266,1183,8461,18910,6075,3776,28761,73242,,,,,,,2020-03-23
Calabria,82,20,178,280,5 7,292,4073,,,,,,,,2020-03-23
Sardegna,76,18,249,343,5 11,359,2568,,,,,,,,2020-03-23
Valle d'Aosta,69,20,290,379,2 12,393,1098,,,,,,,,2020-03-23
Umbria,106,42,408,556,5 16,577,3561,,,,,,,,2020-03-23
Abruzzo,228,52,325,605,20,38,663,3674,,,,,,,2020-03-23
Sicilia,250,60,371,681,27,13,721,6375,,,,,,,2020-03-23
Puglia,285,45,532,862,7 37,906,6761,,,,,,,,2020-03-23
Bolzano,145,33,510,688,7 29,724,6084,,,,,,,,2020-03-23
Basilicata,15,12,62,89,1,90,696,,,,,,,,2020-03-23
Trento,249,46,619,914,68,41,1023,3150,,,,,,,2020-03-23
Campania,266,110,553,929,48,49,1026,5813,,,,,,,2020-03-23
Lazio,718,96,600,1414,63,63,1540,18371,,,,,,,2020-03-23
Liguria,761,133,659,1553,159,212,1924,5538,,,,,,,2020-03-23
Toscana,838,238,1225,2301,51,109,2461,13851,,,,,,,2020-03-23
Marche,882,148,1328,2358,8 203,2569,6782,,,,,,,,2020-03-23
Piemonte,2194,343,1992,4529,17,315,4861,13560,,,,,,,2020-03-23
Veneto,1206,281,3499,4986,327,192,5505,61115,,,,,,,2020-03-23
Emilia Romagna,2846,276,4098,7220,423,892,8535,31200,,,,,,,2020-03-23
Friuli VG,185,41,545,771,105,54,930,7424,,,,,,,2020-03-23
Molise,25,7,18,50,10,7,67,532,,,,,,,2020-03-23
Lombardia,9439,1142,7304,17885,5865,3456,27206,70598,,,,,,,2020-03-22
Calabria,77,17,166,260,5,8,273,3666,,,,,,,2020-03-22
Sardegna,67,16,244,327,5,7,339,2402,,,,,,,2020-03-22
Valle d'Aosta,63,21,270,354,1,9,364,950,,,,,,,2020-03-22
Umbria,97,35,368,500,5,16,521,3135,,,,,,,2020-03-22
Abruzzo,218,49,272,539,15,33,587,3375,,,,,,,2020-03-22
Sicilia,220,55,321,596,26,8,630,5580,,,,,,,2020-03-22
Puglia,252,37,459,748,7,31,786,6160,,,,,,,2020-03-22
Bolzano,146,32,470,648,7,23,678,5718,,,,,,,2020-03-22
Basilicata,13,10,58,81,,0,81,643,,,,,,,2020-03-22
Trento,235,46,604,885,34,35,954,3050,,,,,,,2020-03-22
Campania,243,99,524,866,41,29,936,4943,,,,,,,2020-03-22
Lazio,671,79,522,1272,58,53,1383,17845,,,,,,,2020-03-22
Liguria,736,132,483,1351,143,171,1665,4995,,,,,,,2020-03-22
Toscana,706,215,1223,2144,42,91,2277,13264,,,,,,,2020-03-22
Marche,816,138,1277,2231,6,184,2421,6391,,,,,,,2020-03-22
Piemonte,2118,308,1701,4127,10,283,4420,12701,,,,,,,2020-03-22
Veneto,1113,255,3276,4644,309,169,5122,57671,,,,,,,2020-03-22
Emilia Romagna,2429,269,3692,6390,349,816,7555,28022,,,,,,,2020-03-22
Friuli VG,163,47,528,738,89,47,874,6761,,,,,,,2020-03-22
Molise,24,7,21,52,7,7,66,532,,,,,,,2020-03-22
Lombardia,8258,1093,8019,17370,5050,3095,25515,66730,,,,,,,2020-03-21
Calabria,73,16,136,225,5,5,235,3050,,,,,,,2020-03-21
Sardegna,65,16,240,321,5,4,330,2297,,,,,,,2020-03-21
Valle d'Aosta,62,15,227,304,1,8,313,884,,,,,,,2020-03-21
Umbria,92,29,326,447,5,10,462,2712,,,,,,,2020-03-21
Abruzzo,185,44,265,494,13,22,529,3035,,,,,,,2020-03-21
Sicilia,206,48,204,458,26,6,490,4883,,,,,,,2020-03-21
Puglia,209,33,400,642,4,29,675,5617,,,,,,,2020-03-21
Bolzano,127,30,443,600,1,20,621,5179,,,,,,,2020-03-21
Molise,21,6,20,47,7,7,61,449,,,,,,,2020-03-21
Trento,233,39,448,720,34,28,782,2656,,,,,,,2020-03-21
Campania,233,87,473,793,29,22,844,4448,,,,,,,2020-03-21
Lazio,591,70,425,1086,54,50,1190,13889,,,,,,,2020-03-21
Liguria,598,129,432,1159,125,152,1436,4304,,,,,,,2020-03-21
Toscana,664,202,1039,1905,35,72,2012,11909,,,,,,,2020-03-21
Marche,742,141,1114,1997,2,154,2153,5740,,,,,,,2020-03-21
Piemonte,1976,301,1229,3506,8,238,3752,10701,,,,,,,2020-03-21
Veneto,942,249,3023,4214,257,146,4617,53642,,,,,,,2020-03-21
Emilia Romagna,2267,265,3129,5661,329,715,6705,24620,,,,,,,2020-03-21
Friuli VG,152,37,477,666,82,42,790,5955,,,,,,,2020-03-21
Basilicata,12,7,47,66,,0,66,522,,,,,,,2020-03-21
Lombardia,7735,1050,6635,15420,4295,2549,22264,57174,,,,,,,2020-03-20
Calabria,71,16,114,201,2,4,207,2690,,,,,,,2020-03-20
Sardegna,56,15,217,288,3,2,293,1912,,,,,,,2020-03-20
Valle d'Aosta,54,9,194,257,,7,264,814,,,,,,,2020-03-20
Umbria,75,24,285,384,4,7,395,2303,,,,,,,2020-03-20
Abruzzo,190,48,184,422,10,17,449,2695,,,,,,,2020-03-20
Sicilia,168,42,169,379,25,4,408,4468,,,,,,,2020-03-20
Puglia,191,31,329,551,4,26,581,4789,,,,,,,2020-03-20
Bolzano,99,24,407,530,1,17,548,4433,,,,,,,2020-03-20
Molise,20,6,13,39,6,5,50,426,,,,,,,2020-03-20
Trento,198,34,368,600,29,13,642,2656,,,,,,,2020-03-20
Campania,130,41,531,702,30,17,749,3845,,,,,,,2020-03-20
Lazio,537,47,328,912,53,43,1008,13889,,,,,,,2020-03-20
Liguria,573,121,307,1001,101,119,1221,3794,,,,,,,2020-03-20
Toscana,601,189,923,1713,33,47,1793,10405,,,,,,,2020-03-20
Marche,704,138,1002,1844,,137,1981,5170,,,,,,,2020-03-20
Piemonte,1541,280,1423,3244,8,209,3461,9975,,,,,,,2020-03-20
Veneto,843,236,2598,3677,223,131,4031,49288,,,,,,,2020-03-20
Emilia Romagna,2083,267,2739,5089,239,640,5968,20753,,,,,,,2020-03-20
Friuli VG,143,32,380,555,63,38,656,4964,,,,,,,2020-03-20
Basilicata,8,5,39,52,,0,52,443,,,,,,,2020-03-20
Lombardia,7387,1006,5545,13938,3778,2168,19884,52244,,,,,,,2020-03-19
Calabria,60,13,91,164,2 3,169,2342,,,,,,,,2020-03-19
Sardegna,43,9,152,204,2,206,1334,,,,,,,,2020-03-19
Valle d'Aosta,47,9,153,209,6,215,608,,,,,,,,2020-03-19
Umbria,69,21,238,328,4 2,334,1954,,,,,,,,2020-03-19
Abruzzo,181,47,138,366,8 11,385,2409,,,,,,,,2020-03-19
Sicilia,143,36,142,321,15,4,340,3961,,,,,,,2020-03-19
Puglia,173,31,245,449,4 25,478,4046,,,,,,,,2020-03-19
Bolzano,87,18,316,421,1 14,436,3568,,,,,,,,2020-03-19
Molise,19,6,13,38,6 2,46,426,,,,,,,,2020-03-19
Trento,169,30,292,491,20,12,523,2203,,,,,,,2020-03-19
Campania,213,36,356,605,30,17,652,3544,,,,,,,2020-03-19
Lazio,426,45,270,741,44,38,823,11145,,,,,,,2020-03-19
Liguria,491,112,280,883,85,91,1059,3348,,,,,,,2020-03-19
Toscana,501,178,743,1422,22,38,1482,8873,,,,,,,2020-03-19
Marche,656,141,825,1622,115,1737,4512,,,,,,,,2020-03-19
Piemonte,2279,257,218,2754,3 175,2932,8853,,,,,,,,2020-03-19
Veneto,771,209,2189,3169,200,115,3484,44658,,,,,,,2020-03-19
Emilia Romagna,1900,260,2346,4506,177,531,5214,18344,,,,,,,2020-03-19
Friuli VG,134,29,359,522,41,36,599,4052,,,,,,,2020-03-19
Basilicata,8,5,24,37,37,353,,,,,,,,,2020-03-19
Lombardia,7285,924,4057,12266,3488,1959,17713,48983,,,,,,,2020-03-18
Calabria,45,11,70,126,2,1,129,1668,,,,,,,2020-03-18
Sardegna,42,7,83,132,,2,134,1135,,,,,,,2020-03-18
Valle d'Aosta,41,3,118,162,,3,165,486,,,,,,,2020-03-18
Umbria,54,21,166,241,4,2,247,1601,,,,,,,2020-03-18
Abruzzo,99,41,109,249,7,7,263,2054,,,,,,,2020-03-18
Sicilia,100,29,138,267,12,3,282,3294,,,,,,,2020-03-18
Puglia,156,30,176,362,2,19,383,3433,,,,,,,2020-03-18
Bolzano,79,18,269,366,1,9,376,2844,,,,,,,2020-03-18
Molise,7,6,8,21,6,1,28,361,,,,,,,2020-03-18
Trento,141,22,273,436,12,7,455,2187,,,,,,,2020-03-18
Campania,127,24,272,423,28,9,460,2685,,,,,,,2020-03-18
Lazio,374,44,232,650,42,32,724,11145,,,,,,,2020-03-18
Liguria,401,100,243,744,70,73,887,2912,,,,,,,2020-03-18
Toscana,427,160,704,1291,17,22,1330,7606,,,,,,,2020-03-18
Marche,638,119,719,1476,,92,1568,4109,,,,,,,2020-03-18
Piemonte,1780,227,180,2187,,154,2341,7516,,,,,,,2020-03-18
Veneto,646,195,2112,2953,167,94,3214,40841,,,,,,,2020-03-18
Emilia Romagna,1784,247,1884,3915,152,458,4525,15461,,,,,,,2020-03-18
Friuli VG,128,27,261,416,15,31,462,4958,,,,,,,2020-03-18
Basilicata,9,2,16,27,,0,27,262,,,,,,,2020-03-18
Lombardia,6953,879,4263,12095,2485,1640,16220,46449,,,,,,,2020-03-17
Calabria,45,10,57,112,1,1,114,1293,,,,,,,2020-03-17
Sardegna,36,4,75,115,,2,117,1003,,,,,,,2020-03-17
Valle d'Aosta,35,6,93,134,,2,136,398,,,,,,,2020-03-17
Umbria,36,21,135,192,4,1,197,1323,,,,,,,2020-03-17
Abruzzo,94,32,90,216,7,6,229,1688,,,,,,,2020-03-17
Sicilia,86,28,112,226,8,3,237,2916,,,,,,,2020-03-17
Puglia,155,14,151,320,2,18,340,3077,,,,,,,2020-03-17
Bolzano,71,11,200,282,1,8,291,2149,,,,,,,2020-03-17
Molise,7,5,7,19,5,1,25,301,,,,,,,2020-03-17
Trento,107,22,239,368,10,7,385,1727,,,,,,,2020-03-17
Campania,127,24,272,423,28,9,460,2685,,,,,,,2020-03-17
Lazio,314,44,192,550,34,23,607,9436,,,,,,,2020-03-17
Liguria,299,85,277,661,57,60,778,2509,,,,,,,2020-03-17
Toscana,329,143,552,1024,12,17,1053,6727,,,,,,,2020-03-17
Marche,599,109,594,1302,,69,1371,3225,,,,,,,2020-03-17
Piemonte,1378,206,180,1764,,133,1897,6543,,,,,,,2020-03-17
Veneto,548,171,1769,2488,136,80,2704,35478,,,,,,,2020-03-17
Emilia Romagna,1566,223,1615,3404,134,393,3931,14510,,,,,,,2020-03-17
Friuli VG,104,21,222,347,17,30,394,4958,,,,,,,2020-03-17
Basilicata,5,2,13,20,,0,20,262,,,,,,,2020-03-17
Lombardia,6171,823,3867,10861,2368,1420,14649,43565,,,,,,,2020-03-16
Valle d'Aosta,28,5,70,103,,2,105,287,,,,,,,2020-03-16
Sardegna,39,,66,105,,2,107,797,,,,,,,2020-03-16
Calabria,36,7,44,87,1,1,89,1030,,,,,,,2020-03-16
Abruzzo,71,37,57,165,7,4,176,1533,,,,,,,2020-03-16
Umbria,30,15,114,159,4,1,164,1093,,,,,,,2020-03-16
Sicilia,75,20,108,203,8,2,213,2653,,,,,,,2020-03-16
Puglia,116,6,90,212,2,16,230,2017,,,,,,,2020-03-16
Bolzano,53,11,171,235,,6,241,1740,,,,,,,2020-03-16
Molise,3,5,7,15,5,1,21,253,,,,,,,2020-03-16
Trento,73,19,275,367,5,6,378,1006,,,,,,,2020-03-16
Campania,103,22,238,363,28,9,400,2517,,,,,,,2020-03-16
Lazio,267,31,174,472,32,19,523,9330,,,,,,,2020-03-16
Liguria,255,73,247,575,42,50,667,2189,,,,,,,2020-03-16
Toscana,175,107,559,841,11,14,866,5910,,,,,,,2020-03-16
Piemonte,1045,186,174,1405,,111,1516,5588,,,,,,,2020-03-16
Marche,528,110,547,1185,,57,1242,3225,,,,,,,2020-03-16
Veneto,498,156,1620,2274,130,69,2473,35052,,,,,,,2020-03-16
Emilia Romagna,1362,197,1529,3088,88,346,3522,13096,,,,,,,2020-03-16
Friuli VG,96,19,231,346,18,22,386,4851,,,,,,,2020-03-16
Basilicata,1,2,9,12,,0,12,230,,,,,,,2020-03-16
Lombardia,3698,370,71161,75229,94134,17462,186825,8960,149776,37049,186825,1807884,2897835,46892,2020-10-30
Valle d'Aosta,127,7,1583,1717,1253,166,3136,155,2768,368,3136,25710,40780,685,2020-10-30
Calabria,142,9,2799,2950,1799,114,4863,239,1174,3689,4863,268922,271839,2852,2020-10-30
PA Bolzano,233,18,4310,4561,2966,308,7835,350,7835,0,7835,118867,230235,2528,2020-10-30
PA Trento,118,9,1562,1689,6622,437,8748,222,4956,3792,8748,113372,286096,2856,2020-10-30
Sardegna,323,40,5458,5821,3071,214,9106,298,3460,5646,9106,224602,264292,3566,2020-10-30
Umbria,260,42,5864,6166,3409,121,9696,729,2996,6700,9696,171539,294451,3487,2020-10-30
Abruzzo,355,27,5414,5796,3764,542,10102,428,7498,2604,10102,176636,283894,3303,2020-10-30
Friuli Venezia Giulia,161,35,4339,4535,5186,394,10115,505,9019,1096,10115,227470,532815,6017,2020-10-30
Basilicata,74,7,1254,1335,699,48,2082,95,728,1354,2082,101446,102296,1826,2020-10-30
Marche,262,39,5340,5641,6965,1013,13619,524,13554,65,13619,185912,317571,3565,2020-10-30
Sicilia,895,117,12552,13564,6758,484,20806,984,13165,7641,20806,477579,676669,7293,2020-10-30
Liguria,948,52,7322,8322,17469,1749,27540,999,19564,7976,27540,226812,437287,6234,2020-10-30
Toscana,1007,153,25260,26420,13983,1320,41723,2765,33468,8255,41723,717521,1074698,17834,2020-10-30
Lazio,1873,175,29699,31747,11196,1190,44133,2246,15572,28561,44133,1152217,1411900,25404,2020-10-30
Campania,1385,161,38804,40350,11062,659,52071,3186,49469,2602,52071,634861,937974,18656,2020-10-30
Emilia-Romagna,1157,119,20145,21421,27764,4612,53797,1763,40312,13485,53797,842483,1570748,17577,2020-10-30
Veneto,777,117,25653,26547,25321,2388,54256,3012,24718,29538,54256,898237,2310397,21799,2020-10-30
Piemonte,2547,159,27682,30388,33006,4355,67749,2719,32595,35154,67749,623529,1013484,15977,2020-10-30
Puglia,634,84,9981,10699,6448,713,17860,791,5108,12752,17860,391765,550266,5591,2020-10-30
Molise,18,6,864,888,692,32,1612,114,1562,50,1612,58819,63048,1143,2020-10-30
Lombardia,4033,392,77586,82011,96198,17535,195744,8919,158695,37049,195744,1834360,2944616,46781,2020-10-31
Valle d'Aosta,146,7,1660,1813,1259,168,3240,104,2864,376,3240,25954,41184,404,2020-10-31
Calabria,154,9,2961,3124,1825,116,5065,202,1194,3871,5065,271920,274973,3134,2020-10-31
PA Bolzano,237,18,4845,5100,2970,312,8382,547,8382,0,8382,120339,233334,3099,2020-10-31
PA Trento,121,9,1795,1925,6775,438,9138,390,5180,3958,9138,114145,289152,3056,2020-10-31
Sardegna,349,39,5667,6055,3149,227,9431,325,3565,5866,9431,227323,267615,3323,2020-10-31
Umbria,277,43,6234,6554,3499,126,10179,483,3079,7100,10179,173851,298628,4177,2020-10-31
Abruzzo,371,29,5803,6203,3799,550,10552,450,7739,2813,10552,178791,287781,3887,2020-10-31
Friuli Venezia Giulia,167,36,4929,5132,5312,397,10841,726,9630,1211,10841,229633,539077,6262,2020-10-31
Basilicata,83,7,1356,1446,704,49,2199,117,778,1421,2199,103139,103999,1703,2020-10-31
Marche,275,47,5783,6105,6997,1019,14121,502,14005,116,14121,187640,320766,3195,2020-10-31
Sicilia,962,122,13358,14442,6814,502,21758,952,13785,7973,21758,482882,684775,8106,2020-10-31
Liguria,1036,57,7338,8431,18403,1774,28608,1068,20350,8258,28608,229381,443676,6389,2020-10-31
Toscana,1046,163,26635,27844,15074,1345,44263,2540,35553,8710,44263,727110,1090874,16176,2020-10-31
Lazio,1944,182,31780,33906,11304,1212,46422,2289,15979,30443,46422,1174268,1437667,25767,2020-10-31
Campania,1403,168,42159,43730,11337,673,55740,3669,53119,2621,55740,651607,958834,20860,2020-10-31
Emilia-Romagna,1223,125,21865,23213,27997,4631,55841,2046,41394,14447,55841,849335,1589691,18943,2020-10-31
Veneto,801,123,28255,29179,25373,2401,56953,2697,24864,32089,56953,904337,2328514,18117,2020-10-31
Piemonte,2683,174,29967,32824,33429,4383,70636,2887,33634,37002,70636,636308,1029059,15575,2020-10-31
Puglia,638,87,10668,11393,6506,723,18622,762,5068,13554,18622,396687,556545,6279,2020-10-31
Molise,17,6,933,956,702,37,1695,83,1645,50,1695,59452,63701,653,2020-10-31
Lombardia,4246,418,85411,90075,96687,17589,204351,8607,162163,42188,204351,1856584,2984274,39658,2020-11-01
Valle d'Aosta,161,12,1747,1920,1281,174,3375,135,2972,403,3375,26164,41665,481,2020-11-01
Calabria,161,13,3188,3362,1831,117,5310,245,1208,4102,5310,274781,277844,2871,2020-11-01
PA Bolzano,273,17,5341,5631,2970,315,8916,534,8916,0,8916,121821,236165,2831,2020-11-01
PA Trento,152,9,1939,2100,6807,441,9348,210,5311,4037,9348,114652,291762,2610,2020-11-01
Sardegna,336,43,5999,6378,3218,234,9830,399,3746,6084,9830,230042,270574,2959,2020-11-01
Umbria,295,46,6869,7210,3602,135,10947,768,3247,7700,10947,175572,302117,3489,2020-11-01
Abruzzo,391,32,6210,6633,3854,554,11041,489,6792,4249,11041,180627,291057,3276,2020-11-01
Friuli Venezia Giulia,180,38,5158,5376,5470,398,11244,403,9981,1263,11244,230864,542817,3740,2020-11-01
Basilicata,86,11,1498,1595,705,49,2349,150,840,1509,2349,104650,105510,1511,2020-11-01
Marche,327,42,6354,6723,7060,1021,14804,683,14654,150,14804,189574,323790,3024,2020-11-01
Sicilia,999,132,14193,15324,7011,518,22853,1095,14475,8378,22853,488072,693322,8547,2020-11-01
Liguria,1080,63,7571,8714,18849,1781,29344,736,21066,8278,29344,231090,447720,4044,2020-11-01
Toscana,1106,173,28695,29974,15305,1363,46642,2379,37515,9127,46642,736419,1106715,15841,2020-11-01
Lazio,2055,185,33866,36106,11436,1231,48773,2351,16314,32459,48773,1192749,1460609,22942,2020-11-01
Emilia-Romagna,1267,132,23518,24917,28033,4647,57597,1758,42249,15348,57597,858385,1601730,12039,2020-11-01
Veneto,832,132,30450,31414,25421,2418,59253,2300,25008,34245,59253,910040,2342686,14172,2020-11-01
Campania,1416,170,45592,47178,11746,676,59600,3860,56979,2621,59600,669472,980619,21785,2020-11-01
Piemonte,2844,179,31391,34414,33852,4394,72660,2024,33810,38850,72660,643829,1039308,10249,2020-11-01
Puglia,677,87,11268,12032,6539,731,19302,680,5278,14024,19302,400285,563078,6533,2020-11-01
Molise,18,5,1030,1053,703,40,1796,101,1746,50,1796,60268,64556,855,2020-11-01
Lombardia,4406,435,89577,94418,97576,17635,209629,5278,166581,43048,209629,1871538,3008361,24087,2020-11-02
Valle d'Aosta,167,12,1833,2012,1306,179,3497,122,3080,417,3497,26356,42151,486,2020-11-02
Calabria,164,19,3422,3605,1841,118,5564,254,1208,4356,5564,277221,280187,2343,2020-11-02
PA Bolzano,293,23,5744,6060,2974,319,9353,437,9353,0,9353,122791,238444,2279,2020-11-02
PA Trento,178,11,1980,2169,6922,444,9535,187,5415,4120,9535,115005,292699,937,2020-11-02
Sardegna,339,43,6271,6653,3266,235,10154,324,3838,6316,10154,232724,273941,3367,2020-11-02
Umbria,308,46,6972,7326,3674,140,11140,193,3290,7850,11140,175793,302745,628,2020-11-02
Friuli Venezia Giulia,179,37,5337,5553,5506,403,11462,218,10146,1316,11462,231668,545374,2557,2020-11-02
Abruzzo,401,33,6657,7091,3872,556,11519,478,7083,4436,11519,182672,294594,3537,2020-11-02
Basilicata,88,13,1594,1695,714,51,2460,111,901,1559,2460,106248,107115,1605,2020-11-02
Marche,334,50,6658,7042,7110,1025,15177,373,15000,177,15177,190758,325563,1773,2020-11-02
Sicilia,1025,142,14897,16064,7277,536,23877,1024,15095,8782,23877,492862,701356,8034,2020-11-02
Liguria,1133,57,8104,9294,18859,1790,29943,599,21510,8433,29943,232521,450566,2846,2020-11-02
Toscana,1217,182,30336,31735,15529,1387,48651,2009,39186,9465,48651,743951,1118732,12017,2020-11-02
Lazio,2032,185,35566,37783,11595,1254,50632,1859,16636,33996,50632,1207323,1480183,19574,2020-11-02
Emilia-Romagna,1382,138,24972,26492,28093,4664,59249,1652,43112,16137,59249,865327,1612029,10299,2020-11-02
Veneto,873,136,31924,32933,25437,2427,60797,1544,25103,35694,60797,912972,2350517,7831,2020-11-02
Campania,1486,171,47113,48770,12991,700,62461,2861,59831,2630,62461,680120,996251,15632,2020-11-02
Piemonte,3108,196,32791,36095,34153,4415,74663,2003,34275,40388,74663,652762,1050421,11113,2020-11-02
Puglia,705,88,11776,12569,6619,740,19928,626,5486,14442,19928,402022,567138,4060,2020-11-02
Molise,22,5,1126,1153,703,41,1897,101,1847,50,1897,60969,65282,726,2020-11-02
Lombardia,4740,475,93351,98566,100115,17752,216433,6804,171744,44689,216433,1889116,3040698,32337,2020-11-03
Valle d'Aosta,170,13,1867,2050,1361,180,3591,94,3164,427,3591,26492,42561,410,2020-11-03
Calabria,184,26,3430,3640,2069,121,5830,266,1218,4612,5830,280076,283075,2888,2020-11-03
PA Trento,200,12,2050,2262,6938,447,9647,112,5451,4196,9647,115196,294266,1567,2020-11-03
PA Bolzano,287,28,6237,6552,2976,320,9848,495,9848,0,9848,123854,240990,2546,2020-11-03
Sardegna,337,45,6526,6908,3309,239,10456,302,3975,6481,10456,234643,276430,2489,2020-11-03
Umbria,305,48,7214,7567,3845,148,11560,420,3360,8200,11560,178056,307285,4540,2020-11-03
Friuli Venezia Giulia,205,39,5514,5758,5659,411,11828,366,10476,1352,11828,233148,550607,5233,2020-11-03
Abruzzo,429,38,7180,7647,3909,564,12120,601,7026,5094,12120,184865,298279,3685,2020-11-03
Basilicata,87,11,1681,1779,729,54,2562,102,963,1599,2562,107396,108261,1146,2020-11-03
Marche,374,53,6990,7417,7160,1031,15608,431,15421,187,15608,192435,328103,2540,2020-11-03
Sicilia,1072,150,15584,16806,7569,550,24925,1048,15643,9282,24925,497218,709371,8015,2020-11-03
Liguria,1147,64,8618,9829,19356,1810,30995,1052,21800,9195,30995,235736,457185,6619,2020-11-03
Toscana,1261,190,32466,33917,15667,1403,50987,2336,41133,9854,50987,753032,1133147,14415,2020-11-03
Lazio,2192,197,37340,39729,11837,1275,52841,2209,17037,35804,52841,1227238,1505664,25481,2020-11-03
Emilia-Romagna,1464,153,26731,28348,28123,4687,61158,1912,44063,17095,61158,874120,1635729,23700,2020-11-03
Veneto,1011,142,34013,35166,25471,2458,63095,2298,25215,37880,63095,917684,2362039,11522,2020-11-03
Campania,1497,227,48995,50719,13989,724,65432,2971,62798,2634,65432,688589,1010052,13801,2020-11-03
Piemonte,3379,213,35121,38713,34675,4444,77832,3169,35311,42521,77832,664753,1063115,12694,2020-11-03
Puglia,749,95,12681,13525,6813,753,21091,1163,5882,15209,21091,408246,573093,5955,2020-11-03
Molise,24,6,1214,1244,705,41,1990,93,1940,50,1990,61642,65986,704,2020-11-03
